8
14
33333333
30003003
30003003
30333003
30000003
30003333
30003003
30003003
30000003
30003333
30003003
30003003
30000003
33333333
