8
14
33333333
30003023
30003003
30333003
30000003
30003333
30003023
30003003
30000003
30003333
30003023
30003003
35000003
33333333