0
0
33333333333333333333
70000000000000000007
70000000000000000007
70000000000000000007
70000000000000000007
70000000005000000007
33333333000033333333
33333333000033333333
33333333000033333333
33333333000033333333
30000000000000000003
30000000000000000003
30000000000000000003
30000000000000000003
30000000000000000003
30000000000000000003
30000000000000000003
70000077733888000008
70000073333338000008
70000073333338000008
70000073333338000008
70000073333338000008
70000073333338000008
70000073333338000008
70000073333338000008
70000073333338000008
70000073333338000008
70000073333338000008
70000073333338000008
70000073333338000008
70000073333338000008
70000073333338000008
70000073333338000008
70000073333338000008
70000073333338000008
70000073333338000008
70000073333338000008
70000073333338000008
70000073333338000008
70000073333338000008
70000073333338000008
70000077733888000008
70000002733800000008
70000000733800000008
77777777733888888888