0
0
________________________________
_0000___________________________
_0000________________77777777777
_0000________________70000000007
_0000________________70000000007
_0000________________70000000007
_0000________________77700000777
_0000__________________7000007__
_0000__________________7000007__
_0000____000000008_____7000007__
_0000____000000008_____7000007__
_0000____000000008_____7000007__
_0000____00____________7000007__
_00000000000000000000000000007__
_00000000000000000000000000007__
_00000000000000000000000000008__
_00000000000000000000000000008__
_0000__________________8000008__
_0000__________________8000008__
_0000__________________8000008__
_0000__________________8000008__
_0000__________________8000008__
_0000__________________8000008__
_0000__________________8000008__
_0000________________88800000888
_0000________________82000000008
_0000________________80000000008
_0000________________80000000008
_0000________________88888888888
_0000___________________________
_0000___________________________
_0000________________77777777777
_0000________________70000000007
_0000________________70000000007
_0000________________72000000007
_0000________________77700000777
_0000__________________7000007__
_0000__________________7000007__
_0000____000000007_____7000007__
_0000____000000007_____7000007__
_0000____000000007_____7000007__
_0000____00____________7000007__
_00000000000000000000000000007__
_00000000000000000000000000007__
_00000000000000000000000000008__
_00000000000000000000000000008__
_0000__________________8000008__
_0000__________________8000008__
_0000__________________8000008__
_0000__________________8000008__
_0000__________________8000008__
_0000__________________8000008__
_0000__________________8000008__
_0000________________88800000888
_0000________________80000000008
_0000________________80000000008
_0000________________80000000008
_0000________________88888888888
_0000___________________________
_0000___________________________
_0000________________77777777777
_0000________________70000000007
_0000________________70000000007
_0000________________72000000007
_0000________________77700000777
_0000__________________7000007__
_0000__________________7000007__
_0000____000000007_____7000007__
_0000____000000007_____7000007__
_0000____000000007_____7000007__
_0000____00____________7000007__
_00000000000000000000000000007__
_00000000000000000000000000007__
_00000000000000000000000000008__
_00000000000000000000000000008__
_0000__________________8000008__
_0000__________________8000008__
_0000__________________8000008__
_0000__________________8000008__
_0000__________________8000008__
_0000__________________8000008__
_0000__________________8000008__
_0000________________88800000888
_0000________________80000000008
_0000________________80000000008
_0000________________80000000008
_0000________________88888888888
_0000___________________________
_0000___________________________
_0000________________77777777777
_0000________________70000000007
_0000________________70000000007
_0000________________70000000007
_0000________________77700000777
_0000__________________7000007__
_0000__________________7000007__
_0000____000000008_____7000007__
_0000____000000008_____7000007__
_0000____000000008_____7000007__
_0000____00____________7000007__
_00000000000000000000000000007__
_00000000000000000000000000007__
_00000000000000000000000000008__
_00000000000000000000000000008__
_0000__________________8000008__
_0000__________________8000008__
_0000__________________8000008__
_0000__________________8000008__
_0000__________________8000008__
_0000__________________8000008__
_0000__________________8000008__
_0000________________88800000888
_0000________________82000000008
_0000________________80000000008
_0000________________80000000008
_0000________________88888888888
_0000___________________________
_0000___________________________
_0000________________77777777777
_0000________________70000000007
_0000________________70000000007
_0000________________72000000007
_0000________________77700000777
_0000__________________7000007__
_0000__________________7000007__
_0000____000000007_____7000007__
_0000____000000007_____7000007__
_0000____000000007_____7000007__
_0000____00____________7000007__
_00000000000000000000000000007__
_00000000000000000000000000007__
_00000000000000000000000000008__
_00000000000000000000000000008__
_0000__________________8000008__
_0000__________________8000008__
_0000__________________8000008__
_0000__________________8000008__
_0000__________________8000008__
_0000__________________8000008__
_0000__________________8000008__
_0000________________88800000888
_0000________________80000000008
_0000________________80000000008
_0000________________80000000008
_0000________________88888888888
_0000___________________________
________________________________