0
0
_______________________________________
_0000_________________000000__000000___
_0000_________________000000__000000___
_0000_________________000000__000000___
_0000_________________0000______0000___
_0000_________________0000______0000___
_0000_________________0000______0000___
_0000_________________0000______0000___
_0000_________________0000______0000___
_0000_________________0000______0000___
_0000_________________00007778880000___
_0000_________________00000000000000___
_0000_________________00000000000000___
_0000_________________00000000000000___
_0000_____________________700007_______
_0000_____________________700007_______
_0000_____________________700007_______
_0000____000000008________700007_______
_0000____000000008________700007_______
_0000____000000008________700007_______
_0000____00_______________700007_______
_0000000000000000000000000000000000000_
_0000000000000000000000000000000000000_
_0000000000000000000000000000000000000_
_0000000000000000000000000000000000000_
_0000_____________________800008_______
_0000_____________________800008_______
_0000_____________________800008_______
_0000_____________________800008_______
_0000_____________________800008_______
_0000_____________________800008_______
_0000_____________________800008_______
_0000_________________00000000000000___
_0000_________________00000000000000___
_0000_________________00007778880000___
_0000_________________0000______0000___
_0000_________________0000______0000___
_0000_________________0000______0000___
_0000_________________0000______0000___
_0000_________________0000______0000___
_0000_________________0000______0000___
_0000_________________000000__200000___
_0000_________________000000__000000___
_0000_________________000000__000000___
_0000__________________________________
_0000__________________________________
_0000_________________000000__000000___
_0000_________________000000__000000___
_0000_________________000002__000000___
_0000_________________0000______0000___
_0000_________________0000______0000___
_0000_________________0000______0000___
_0000_________________0000______0000___
_0000_________________0000______0000___
_0000_________________0000______0000___
_0000_________________00007778880000___
_0000_________________00000000000000___
_0000_________________00000000000000___
_0000_________________00000000000000___
_0000_____________________700007_______
_0000_____________________700007_______
_0000_____________________700007_______
_0000____000000007________700007_______
_0000____000000007________700007_______
_0000____000000007________700007_______
_0000____00_______________700007_______
_0000000000000000000000000000000000000_
_0000000000000000000000000000000000000_
_0000000000000000000000000000000000000_
_0000000000000000000000000000000000000_
_0000_____________________800008_______
_0000_____________________800008_______
_0000_____________________800008_______
_0000_____________________800008_______
_0000_____________________800008_______
_0000_____________________800008_______
_0000_____________________800008_______
_0000_________________00000000000000___
_0000_________________00000000000000___
_0000_________________00007778880000___
_0000_________________0000______0000___
_0000_________________0000______0000___
_0000_________________0000______0000___
_0000_________________0000______0000___
_0000_________________0000______0000___
_0000_________________0000______0000___
_0000_________________000000__000000___
_0000_________________000000__000000___
_0000_________________000000__000000___
_0000__________________________________
_0000__________________________________
_0000_________________000000__000000___
_0000_________________000000__000000___
_0000_________________000002__000000___
_0000_________________0000______0000___
_0000_________________0000______0000___
_0000_________________0000______0000___
_0000_________________0000______0000___
_0000_________________0000______0000___
_0000_________________0000______0000___
_0000_________________00007778880000___
_0000_________________00000000000000___
_0000_________________00000000000000___
_0000_________________00000000000000___
_0000_____________________700007_______
_0000_____________________700007_______
_0000_____________________700007_______
_0000____000000007________700007_______
_0000____000000007________700007_______
_0000____000000007________700007_______
_0000____00_______________700007_______
_0000000000000000000000000000000000000_
_0000000000000000000000000000000000000_
_0000000000000000000000000000000000000_
_0000000000000000000000000000000000000_
_0000_____________________800008_______
_0000_____________________800008_______
_0000_____________________800008_______
_0000_____________________800008_______
_0000_____________________800008_______
_0000_____________________800008_______
_0000_____________________800008_______
_0000_________________00000000000000___
_0000_________________00000000000000___
_0000_________________00007778880000___
_0000_________________0000______0000___
_0000_________________0000______0000___
_0000_________________0000______0000___
_0000_________________0000______0000___
_0000_________________0000______0000___
_0000_________________0000______0000___
_0000_________________000000__000000___
_0000_________________000000__000000___
_0000_________________000000__000000___
_0000__________________________________
_0000__________________________________
_0000_________________000000__000000___
_0000_________________000000__000000___
_0000_________________000000__000000___
_0000_________________0000______0000___
_0000_________________0000______0000___
_0000_________________0000______0000___
_0000_________________0000______0000___
_0000_________________0000______0000___
_0000_________________0000______0000___
_0000_________________00007778880000___
_0000_________________00000000000000___
_0000_________________00000000000000___
_0000_________________00000000000000___
_0000_____________________700007_______
_0000_____________________700007_______
_0000_____________________700007_______
_0000____000000008________700007_______
_0000____000000008________700007_______
_0000____000000008________700007_______
_0000____00_______________700007_______
_0000000000000000000000000000000000000_
_0000000000000000000000000000000000000_
_0000000000000000000000000000000000000_
_0000000000000000000000000000000000000_
_0000_____________________800008_______
_0000_____________________800008_______
_0000_____________________800008_______
_0000_____________________800008_______
_0000_____________________800008_______
_0000_____________________800008_______
_0000_____________________800008_______
_0000_________________00000000000000___
_0000_________________00000000000000___
_0000_________________00007778880000___
_0000_________________0000______0000___
_0000_________________0000______0000___
_0000_________________0000______0000___
_0000_________________0000______0000___
_0000_________________0000______0000___
_0000_________________0000______0000___
_0000_________________000000__200000___
_0000_________________000000__000000___
_0000_________________000000__000000___
_0000__________________________________
_0000__________________________________
_0000_________________000000__000000___
_0000_________________000000__000000___
_0000_________________000000__000000___
_0000_________________0000______0000___
_0000_________________0000______0000___
_0000_________________0000______0000___
_0000_________________0000______0000___
_0000_________________0000______0000___
_0000_________________0000______0000___
_0000_________________00007778880000___
_0000_________________00000000000000___
_0000_________________00000000000000___
_0000_________________00000000000000___
_0000_____________________700007_______
_0000_____________________700007_______
_0000_____________________700007_______
_0000____000000008________700007_______
_0000____000000008________700007_______
_0000____000000008________700007_______
_0000____00_______________700007_______
_0000000000000000000000000000000000000_
_0000000000000000000000000000000000000_
_0000000000000000000000000000000000000_
_0000000000000000000000000000000000000_
_0000_____________________800008_______
_0000_____________________800008_______
_0000_____________________800008_______
_0000_____________________800008_______
_0000_____________________800008_______
_0000_____________________800008_______
_0000_____________________800008_______
_0000_________________00000000000000___
_0000_________________00000000000000___
_0000_________________00007778880000___
_0000_________________0000______0000___
_0000_________________0000______0000___
_0000_________________0000______0000___
_0000_________________0000______0000___
_0000_________________0000______0000___
_0000_________________0000______0000___
_0000_________________000000__200000___
_0000_________________000000__000000___
_0000_________________000000__000000___
_______________________________________