0
0
______________________________________________________________
_0000_________________________________________________________
_0000_____________________________8888888888888888888888888888
_0000______________________3333333444444444444444405555555555_
_0000______________________3333333444444444444444405555555555_
_0000______________________3333333444444444444444485555555555_
_0000___222222222__________3333333444444444444444485555555555_
_0000___222222222__________3333333444444444444444485555555555_
_0000___222222222__________33333338888888888888888855555555558
_0000___22_________________33333338_______________855555555558
_0000111111111111111111111133333338_______________888888888888
_000011111111111111111111113333333____________________________
_000011111111111111111111113333333____________________________
_0000111111111111111111111133333337_______________777777777777
_0000______________________33333337_______________766666666667
_0000______________________33333337777777777777777766666666667
_0000______________________3333333444444444444444476666666666_
_0000______________________3333333444444444444444476666666666_
_0000______________________3333333444444444444444476666666666_
_0000______________________3333333444444444444444406666666666_
_0000______________________3333333444444444444444406666666666_
_0000_____________________________7777777777777777777777777777
_0000_________________________________________________________
_0000_________________________________________________________
_0000_____________________________8888888888888888888888888888
_0000______________________3333333444444444444444405555555555_
_0000______________________3333333444444444444444405555555555_
_0000______________________3333333444444444444444485555555555_
_0000___222222222__________3333333444444444444444485555555555_
_0000___222222222__________3333333444444444444444485555555555_
_0000___222222222__________33333338888888888888888855555555558
_0000___22_________________33333338_______________855555555558
_0000111111111111111111111133333338_______________888888888888
_000011111111111111111111113333333____________________________
_000011111111111111111111113333333____________________________
_0000111111111111111111111133333337_______________777777777777
_0000______________________33333337_______________766666666667
_0000______________________33333337777777777777777766666666667
_0000______________________3333333444444444444444476666666666_
_0000______________________3333333444444444444444476666666666_
_0000______________________3333333444444444444444476666666666_
_0000______________________3333333444444444444444406666666666_
_0000______________________3333333444444444444444406666666666_
_0000_____________________________7777777777777777777777777777
_0000_________________________________________________________
_0000_________________________________________________________
_0000_____________________________8888888888888888888888888888
_0000______________________3333333444444444444444405555555555_
_0000______________________3333333444444444444444405555555555_
_0000______________________3333333444444444444444485555555555_
_0000___222222222__________3333333444444444444444485555555555_
_0000___222222222__________3333333444444444444444485555555555_
_0000___222222222__________33333338888888888888888855555555558
_0000___22_________________33333338_______________855555555558
_0000111111111111111111111133333338_______________888888888888
_000011111111111111111111113333333____________________________
_000011111111111111111111113333333____________________________
_0000111111111111111111111133333337_______________777777777777
_0000______________________33333337_______________766666666667
_0000______________________33333337777777777777777766666666667
_0000______________________3333333444444444444444476666666666_
_0000______________________3333333444444444444444476666666666_
_0000______________________3333333444444444444444476666666666_
_0000______________________3333333444444444444444406666666666_
_0000______________________3333333444444444444444406666666666_
_0000_____________________________7777777777777777777777777777
_0000_________________________________________________________
_0000_________________________________________________________
_0000_____________________________8888888888888888888888888888
_0000______________________3333333444444444444444405555555555_
_0000______________________3333333444444444444444405555555555_
_0000______________________3333333444444444444444485555555555_
_0000___222222222__________3333333444444444444444485555555555_
_0000___222222222__________3333333444444444444444485555555555_
_0000___222222222__________33333338888888888888888855555555558
_0000___22_________________33333338_______________855555555558
_0000111111111111111111111133333338_______________888888888888
_000011111111111111111111113333333____________________________
_000011111111111111111111113333333____________________________
_0000111111111111111111111133333337_______________777777777777
_0000______________________33333337_______________766666666667
_0000______________________33333337777777777777777766666666667
_0000______________________3333333444444444444444476666666666_
_0000______________________3333333444444444444444476666666666_
_0000______________________3333333444444444444444476666666666_
_0000______________________3333333444444444444444406666666666_
_0000______________________3333333444444444444444406666666666_
_0000_____________________________7777777777777777777777777777
_0000_________________________________________________________
_0000_________________________________________________________
_0000_____________________________8888888888888888888888888888
_0000______________________3333333444444444444444405555555555_
_0000______________________3333333444444444444444405555555555_
_0000______________________3333333444444444444444485555555555_
_0000___222222222__________3333333444444444444444485555555555_
_0000___222222222__________3333333444444444444444485555555555_
_0000___222222222__________33333338888888888888888855555555558
_0000___22_________________33333338_______________855555555558
_0000111111111111111111111133333338_______________888888888888
_000011111111111111111111113333333____________________________
_000011111111111111111111113333333____________________________
_0000111111111111111111111133333337_______________777777777777
_0000______________________33333337_______________766666666667
_0000______________________33333337777777777777777766666666667
_0000______________________3333333444444444444444476666666666_
_0000______________________3333333444444444444444476666666666_
_0000______________________3333333444444444444444476666666666_
_0000______________________3333333444444444444444406666666666_
_0000______________________3333333444444444444444406666666666_
_0000_____________________________7777777777777777777777777777
_0000_________________________________________________________
______________________________________________________________
