0
0
____________________________________________________________
_0000____________________7777777777777777_8888888888888888__
_0000____________________7000000000000007_8000000000000008__
_0000____________________7000000000000007_8000000000000008__
_0000____________________7000000000000007_8000000000000008__
_0000____________________7000000000000007_8000000000000008__
_0000____000000008_______7000000000000007_8000000000000008__
_0000____000000008_______7000000000000007_8000000000000008__
_0000____000000008_______7000000000000007_8200000000000008__
_0000____00______________7777770000777777_8888880000888888__
_0000000000000000000000000000000000000000000000000000000000_
_0000000000000000000000000000000000000000000000000000000000_
_0000000000000000000000000000000000000000000000000000000000_
_0000000000000000000000000000000000000000000000000000000000_
_0000____________________7777770000777777_8888880000888888__
_0000____________________7000000000000007_8200000000000008__
_0000____________________7000000000000007_8000000000000008__
_0000____________________7000000000000007_8000000000000008__
_0000____________________7000000000000007_8000000000000008__
_0000____________________7000000000000007_8000000000000008__
_0000____________________7000000000000007_8000000000000008__
_0000____________________7000000000000007_8000000000000008__
_0000____________________7777777777777777_8888888888888888__
_0000_______________________________________________________
_0000_______________________________________________________
_0000____________________7777777777777777_8888888888888888__
_0000____________________7000000000000007_8000000000000008__
_0000____________________7000000000000007_8000000000000008__
_0000____________________7000000000000007_8000000000000008__
_0000____________________7000000000000007_8000000000000008__
_0000____000000007_______7000000000000007_8000000000000008__
_0000____000000007_______7000000000000007_8000000000000008__
_0000____000000007_______7200000000000007_8000000000000008__
_0000____00______________7777770000777777_8888880000888888__
_0000000000000000000000000000000000000000000000000000000000_
_0000000000000000000000000000000000000000000000000000000000_
_0000000000000000000000000000000000000000000000000000000000_
_0000000000000000000000000000000000000000000000000000000000_
_0000____________________7777770000777777_8888880000888888__
_0000____________________7200000000000007_8000000000000008__
_0000____________________7000000000000007_8000000000000008__
_0000____________________7000000000000007_8000000000000008__
_0000____________________7000000000000007_8000000000000008__
_0000____________________7000000000000007_8000000000000008__
_0000____________________7000000000000007_8000000000000008__
_0000____________________7000000000000007_8000000000000008__
_0000____________________7777777777777777_8888888888888888__
_0000_______________________________________________________
_0000_______________________________________________________
_0000____________________7777777777777777_8888888888888888__
_0000____________________7000000000000007_8000000000000008__
_0000____________________7000000000000007_8000000000000008__
_0000____________________7000000000000007_8000000000000008__
_0000____________________7000000000000007_8000000000000008__
_0000____000000008_______7000000000000007_8000000000000008__
_0000____000000008_______7000000000000007_8000000000000008__
_0000____000000008_______7000000000000007_8200000000000008__
_0000____00______________7777770000777777_8888880000888888__
_0000000000000000000000000000000000000000000000000000000000_
_0000000000000000000000000000000000000000000000000000000000_
_0000000000000000000000000000000000000000000000000000000000_
_0000000000000000000000000000000000000000000000000000000000_
_0000____________________7777770000777777_8888880000888888__
_0000____________________7000000000000007_8200000000000008__
_0000____________________7000000000000007_8000000000000008__
_0000____________________7000000000000007_8000000000000008__
_0000____________________7000000000000007_8000000000000008__
_0000____________________7000000000000007_8000000000000008__
_0000____________________7000000000000007_8000000000000008__
_0000____________________7000000000000007_8000000000000008__
_0000____________________7777777777777777_8888888888888888__
_0000_______________________________________________________
_0000_______________________________________________________
_0000____________________7777777777777777_8888888888888888__
_0000____________________7000000000000007_8000000000000008__
_0000____________________7000000000000007_8000000000000008__
_0000____________________7000000000000007_8000000000000008__
_0000____________________7000000000000007_8000000000000008__
_0000____000000007_______7000000000000007_8000000000000008__
_0000____000000007_______7000000000000007_8000000000000008__
_0000____000000007_______7200000000000007_8000000000000008__
_0000____00______________7777770000777777_8888880000888888__
_0000000000000000000000000000000000000000000000000000000000_
_0000000000000000000000000000000000000000000000000000000000_
_0000000000000000000000000000000000000000000000000000000000_
_0000000000000000000000000000000000000000000000000000000000_
_0000____________________7777770000777777_8888880000888888__
_0000____________________7200000000000007_8000000000000008__
_0000____________________7000000000000007_8000000000000008__
_0000____________________7000000000000007_8000000000000008__
_0000____________________7000000000000007_8000000000000008__
_0000____________________7000000000000007_8000000000000008__
_0000____________________7000000000000007_8000000000000008__
_0000____________________7000000000000007_8000000000000008__
_0000____________________7777777777777777_8888888888888888__
_0000_______________________________________________________
_0000_______________________________________________________
_0000____________________7777777777777777_8888888888888888__
_0000____________________7000000000000007_8000000000000008__
_0000____________________7000000000000007_8000000000000008__
_0000____________________7000000000000007_8000000000000008__
_0000____________________7000000000000007_8000000000000008__
_0000____000000007_______7000000000000007_8000000000000008__
_0000____000000007_______7000000000000007_8000000000000008__
_0000____000000007_______7200000000000007_8000000000000008__
_0000____00______________7777770000777777_8888880000888888__
_0000000000000000000000000000000000000000000000000000000000_
_0000000000000000000000000000000000000000000000000000000000_
_0000000000000000000000000000000000000000000000000000000000_
_0000000000000000000000000000000000000000000000000000000000_
_0000____________________7777770000777777_8888880000888888__
_0000____________________7200000000000007_8000000000000008__
_0000____________________7000000000000007_8000000000000008__
_0000____________________7000000000000007_8000000000000008__
_0000____________________7000000000000007_8000000000000008__
_0000____________________7000000000000007_8000000000000008__
_0000____________________7000000000000007_8000000000000008__
_0000____________________7000000000000007_8000000000000008__
_0000____________________7777777777777777_8888888888888888__
_0000_______________________________________________________
____________________________________________________________