0
0
_____________________________________
______________000000000______________
______________000000000______________
______________000000000______________
______________000000000______________
______________000000000______________
______________000000000______________
______________000000000______________
______________000000000______________
_00000000000000000000000000000000000_
_00000000000000000000000000000000000_
_000000000000___________000000000000_
_008000000000_000000000_000000000700_
_008000000000_000000000_000000000700_
_008000000000_000000000_000000000702_
_008000000000_000000000_000000000700_
_008000000000_000000007_000000000700_
_000000000000____000____000000000000_
_00000000000000000000000000000000000_
_00000000000000000000000000000000000_
______________000000000______________
______________000000000______________
______________000000000______________
______________000000000______________
______________000000000______________
______________000000000______________
______________000000000______________
______________000000000______________
______________000000000______________
______________000000000______________
______________000000000______________
______________000000000______________
______________000000000______________
______________000000000______________
______________000000000______________
______________000000000______________
______________000000000______________
______________000000000______________
_00000000000000000000000000000000000_
_00000000000000000000000000000000000_
_000000000000___________000000000000_
_008000000000_000000000_000000000700_
_008000000000_000000000_000000000700_
_208000000000_000000000_000000000700_
_008000000000_000000000_000000000700_
_008000000000_800000000_000000000700_
_000000000000____000____000000000000_
_00000000000000000000000000000000000_
_00000000000000000000000000000000000_
______________000000000______________
______________000000000______________
______________000000000______________
______________000000000______________
______________000000000______________
______________000000000______________
______________000000000______________
______________000000000______________
______________000000000______________
______________000000000______________
______________000000000______________
______________000000000______________
______________000000000______________
______________000000000______________
______________000000000______________
______________000000000______________
______________000000000______________
______________000000000______________
_00000000000000000000000000000000000_
_00000000000000000000000000000000000_
_000000000000___________000000000000_
_008000000000_000000000_000000000700_
_008000000000_000000000_000000000700_
_208000000000_000000000_000000000700_
_008000000000_000000000_000000000700_
_008000000000_800000000_000000000700_
_000000000000____000____000000000000_
_00000000000000000000000000000000000_
_00000000000000000000000000000000000_
______________000000000______________
______________000000000______________
______________000000000______________
______________000000000______________
______________000000000______________
______________000000000______________
______________000000000______________
______________000000000______________
______________000000000______________
______________000000000______________
______________000000000______________
______________000000000______________
______________000000000______________
______________000000000______________
______________000000000______________
______________000000000______________
______________000000000______________
______________000000000______________
_00000000000000000000000000000000000_
_00000000000000000000000000000000000_
_000000000000___________000000000000_
_008000000000_000000000_000000000700_
_008000000000_000000000_000000000700_
_008000000000_000000000_000000000702_
_008000000000_000000000_000000000700_
_008000000000_000000007_000000000700_
_000000000000____000____000000000000_
_00000000000000000000000000000000000_
_00000000000000000000000000000000000_
______________000000000______________
______________000000000______________
______________000000000______________
______________000000000______________
______________000000000______________
______________000000000______________
______________000000000______________
______________000000000______________
______________000000000______________
______________000000000______________
______________000000000______________
______________000000000______________
______________000000000______________
______________000000000______________
______________000000000______________
______________000000000______________
______________000000000______________
______________000000000______________
_00000000000000000000000000000000000_
_00000000000000000000000000000000000_
_000000000000___________000000000000_
_008000000000_000000000_000000000700_
_008000000000_000000000_000000000700_
_208000000000_000000000_000000000700_
_008000000000_000000000_000000000700_
_008000000000_800000000_000000000700_
_000000000000____000____000000000000_
_00000000000000000000000000000000000_
_00000000000000000000000000000000000_
______________000000000______________
______________000000000______________
______________000000000______________
______________000000000______________
______________000000000______________
______________000000000______________
______________000000000______________
______________000000000______________
______________000000000______________
______________000000000______________
______________000000000______________
______________000000000______________
______________000000000______________
______________000000000______________
______________000000000______________
______________000000000______________
_____________________________________