0
0
___________________________________________________________________
_0000______________________________________________________________
_0000___________________________________________000000000000000000_
_0000___________________________________________000000000000000000_
_0000_______________________________000000000000000000000000000000_
_0000_______________________________000000000000000000007_____0000_
_0000_______________________________000000000000000000007__________
_0000_______________________________000000000000000000008__________
_0000_______________________________000000000000000000008_____2000_
_0000________________000000000000000000000000000000000000000000000_
_0000________________000000000000000000000008___000000000000000000_
_0000________________000000000000000000000008___000000000000000000_
_0000________________000000000000000000000008______________________
_0000________________000000000000000000000007______________________
_0000________________000000000000000000000007___000000000000000000_
_0000________________000000000000000000000007___000000000000000000_
_0000________________000000000000000000000000000000000000000000000_
_0000________________00000008_______000000000000000000007_____0000_
_0000____000000008___00000008_______000000000000000000007__________
_0000____000000008___00000008_______000000000000000000008__________
_0000____000000008___00000008_______000000000000000000008_____0000_
_0000____00__________00000008_______000000000000000000000000000000_
_0000000000000000000000000008___________________000000000000000000_
_000000000000000000000000000____________________000000000000000000_
_000000000000000000000000000_______________________________________
_000000000000000000000000000_______________________________________
_000000000000000000000000000____________________000000000000000000_
_0000000000000000000000000007___________________000000000000000000_
_0000________________00000007_______000000000000000000000000000000_
_0000________________00000007_______000000000000000000008_____0000_
_0000________________00000007_______000000000000000000008__________
_0000________________00000007_______000000000000000000007__________
_0000________________00000007_______000000000000000000007_____0000_
_0000________________000000000000000000000000000000000000000000000_
_0000________________000000000000000000000007___000000000000000000_
_0000________________000000000000000000000007___000000000000000000_
_0000________________000000000000000000000007______________________
_0000________________000000000000000000000008______________________
_0000________________000000000000000000000008___000000000000000000_
_0000________________000000000000000000000008___000000000000000000_
_0000________________000000000000000000000000000000000000000000000_
_0000_______________________________000000000000000000008_____0000_
_0000_______________________________000000000000000000008__________
_0000_______________________________000000000000000000007__________
_0000_______________________________000000000000000000007_____0000_
_0000_______________________________000000000000000000000000000000_
_0000___________________________________________000000000000000000_
_0000___________________________________________000000000000000000_
_0000______________________________________________________________
_0000______________________________________________________________
_0000___________________________________________000000000000000000_
_0000___________________________________________000000000000000000_
_0000_______________________________000000000000000000000000000000_
_0000_______________________________000000000000000000007_____0000_
_0000_______________________________000000000000000000007__________
_0000_______________________________000000000000000000008__________
_0000_______________________________000000000000000000008_____0000_
_0000________________000000000000000000000000000000000000000000000_
_0000________________000000000000000000000008___000000000000000000_
_0000________________000000000000000000000008___000000000000000000_
_0000________________000000000000000000000008______________________
_0000________________000000000000000000000007______________________
_0000________________000000000000000000000007___000000000000000000_
_0000________________000000000000000000000007___000000000000000000_
_0000________________000000000000000000000000000000000000000000000_
_0000________________00000008_______000000000000000000007_____0000_
_0000____000000007___00000008_______000000000000000000007__________
_0000____000000007___00000008_______000000000000000000008__________
_0000____000000007___00000008_______000000000000000000008_____0000_
_0000____00__________00000008_______000000000000000000000000000000_
_0000000000000000000000000008___________________000000000000000000_
_000000000000000000000000000____________________000000000000000000_
_000000000000000000000000000_______________________________________
_000000000000000000000000000_______________________________________
_000000000000000000000000000____________________000000000000000000_
_0000000000000000000000000007___________________000000000000000000_
_0000________________00000007_______000000000000000000000000000000_
_0000________________00000007_______000000000000000000008_____0000_
_0000________________00000007_______000000000000000000008__________
_0000________________00000007_______000000000000000000007__________
_0000________________00000007_______000000000000000000007_____2000_
_0000________________000000000000000000000000000000000000000000000_
_0000________________000000000000000000000007___000000000000000000_
_0000________________000000000000000000000007___000000000000000000_
_0000________________000000000000000000000007______________________
_0000________________000000000000000000000008______________________
_0000________________000000000000000000000008___000000000000000000_
_0000________________000000000000000000000008___000000000000000000_
_0000________________000000000000000000000000000000000000000000000_
_0000_______________________________000000000000000000008_____0000_
_0000_______________________________000000000000000000008__________
_0000_______________________________000000000000000000007__________
_0000_______________________________000000000000000000007_____0000_
_0000_______________________________000000000000000000000000000000_
_0000___________________________________________000000000000000000_
_0000___________________________________________000000000000000000_
_0000______________________________________________________________
_0000______________________________________________________________
_0000___________________________________________000000000000000000_
_0000___________________________________________000000000000000000_
_0000_______________________________000000000000000000000000000000_
_0000_______________________________000000000000000000007_____0000_
_0000_______________________________000000000000000000007__________
_0000_______________________________000000000000000000008__________
_0000_______________________________000000000000000000008_____2000_
_0000________________000000000000000000000000000000000000000000000_
_0000________________000000000000000000000008___000000000000000000_
_0000________________000000000000000000000008___000000000000000000_
_0000________________000000000000000000000008______________________
_0000________________000000000000000000000007______________________
_0000________________000000000000000000000007___000000000000000000_
_0000________________000000000000000000000007___000000000000000000_
_0000________________000000000000000000000000000000000000000000000_
_0000________________00000008_______000000000000000000007_____0000_
_0000____000000008___00000008_______000000000000000000007__________
_0000____000000008___00000008_______000000000000000000008__________
_0000____000000008___00000008_______000000000000000000008_____0000_
_0000____00__________00000008_______000000000000000000000000000000_
_0000000000000000000000000008___________________000000000000000000_
_000000000000000000000000000____________________000000000000000000_
_000000000000000000000000000_______________________________________
_000000000000000000000000000_______________________________________
_000000000000000000000000000____________________000000000000000000_
_0000000000000000000000000007___________________000000000000000000_
_0000________________00000007_______000000000000000000000000000000_
_0000________________00000007_______000000000000000000008_____0000_
_0000________________00000007_______000000000000000000008__________
_0000________________00000007_______000000000000000000007__________
_0000________________00000007_______000000000000000000007_____0000_
_0000________________000000000000000000000000000000000000000000000_
_0000________________000000000000000000000007___000000000000000000_
_0000________________000000000000000000000007___000000000000000000_
_0000________________000000000000000000000007______________________
_0000________________000000000000000000000008______________________
_0000________________000000000000000000000008___000000000000000000_
_0000________________000000000000000000000008___000000000000000000_
_0000________________000000000000000000000000000000000000000000000_
_0000_______________________________000000000000000000008_____0000_
_0000_______________________________000000000000000000008__________
_0000_______________________________000000000000000000007__________
_0000_______________________________000000000000000000007_____0000_
_0000_______________________________000000000000000000000000000000_
_0000___________________________________________000000000000000000_
_0000___________________________________________000000000000000000_
_0000______________________________________________________________
_0000______________________________________________________________
_0000___________________________________________000000000000000000_
_0000___________________________________________000000000000000000_
_0000_______________________________000000000000000000000000000000_
_0000_______________________________000000000000000000007_____0000_
_0000_______________________________000000000000000000007__________
_0000_______________________________000000000000000000008__________
_0000_______________________________000000000000000000008_____2000_
_0000________________000000000000000000000000000000000000000000000_
_0000________________000000000000000000000008___000000000000000000_
_0000________________000000000000000000000008___000000000000000000_
_0000________________000000000000000000000008______________________
_0000________________000000000000000000000007______________________
_0000________________000000000000000000000007___000000000000000000_
_0000________________000000000000000000000007___000000000000000000_
_0000________________000000000000000000000000000000000000000000000_
_0000________________00000008_______000000000000000000007_____0000_
_0000____000000008___00000008_______000000000000000000007__________
_0000____000000008___00000008_______000000000000000000008__________
_0000____000000008___00000008_______000000000000000000008_____0000_
_0000____00__________00000008_______000000000000000000000000000000_
_0000000000000000000000000008___________________000000000000000000_
_000000000000000000000000000____________________000000000000000000_
_000000000000000000000000000_______________________________________
_000000000000000000000000000_______________________________________
_000000000000000000000000000____________________000000000000000000_
_0000000000000000000000000007___________________000000000000000000_
_0000________________00000007_______000000000000000000000000000000_
_0000________________00000007_______000000000000000000008_____0000_
_0000________________00000007_______000000000000000000008__________
_0000________________00000007_______000000000000000000007__________
_0000________________00000007_______000000000000000000007_____0000_
_0000________________000000000000000000000000000000000000000000000_
_0000________________000000000000000000000007___000000000000000000_
_0000________________000000000000000000000007___000000000000000000_
_0000________________000000000000000000000007______________________
_0000________________000000000000000000000008______________________
_0000________________000000000000000000000008___000000000000000000_
_0000________________000000000000000000000008___000000000000000000_
_0000________________000000000000000000000000000000000000000000000_
_0000_______________________________000000000000000000008_____0000_
_0000_______________________________000000000000000000008__________
_0000_______________________________000000000000000000007__________
_0000_______________________________000000000000000000007_____0000_
_0000_______________________________000000000000000000000000000000_
_0000___________________________________________000000000000000000_
_0000___________________________________________000000000000000000_
_0000______________________________________________________________
_0000______________________________________________________________
_0000___________________________________________000000000000000000_
_0000___________________________________________000000000000000000_
_0000_______________________________000000000000000000000000000000_
_0000_______________________________000000000000000000007_____0000_
_0000_______________________________000000000000000000007__________
_0000_______________________________000000000000000000008__________
_0000_______________________________000000000000000000008_____0000_
_0000________________000000000000000000000000000000000000000000000_
_0000________________000000000000000000000008___000000000000000000_
_0000________________000000000000000000000008___000000000000000000_
_0000________________000000000000000000000008______________________
_0000________________000000000000000000000007______________________
_0000________________000000000000000000000007___000000000000000000_
_0000________________000000000000000000000007___000000000000000000_
_0000________________000000000000000000000000000000000000000000000_
_0000________________00000008_______000000000000000000007_____0000_
_0000____000000007___00000008_______000000000000000000007__________
_0000____000000007___00000008_______000000000000000000008__________
_0000____000000007___00000008_______000000000000000000008_____0000_
_0000____00__________00000008_______000000000000000000000000000000_
_0000000000000000000000000008___________________000000000000000000_
_000000000000000000000000000____________________000000000000000000_
_000000000000000000000000000_______________________________________
_000000000000000000000000000_______________________________________
_000000000000000000000000000____________________000000000000000000_
_0000000000000000000000000007___________________000000000000000000_
_0000________________00000007_______000000000000000000000000000000_
_0000________________00000007_______000000000000000000008_____0000_
_0000________________00000007_______000000000000000000008__________
_0000________________00000007_______000000000000000000007__________
_0000________________00000007_______000000000000000000007_____2000_
_0000________________000000000000000000000000000000000000000000000_
_0000________________000000000000000000000007___000000000000000000_
_0000________________000000000000000000000007___000000000000000000_
_0000________________000000000000000000000007______________________
_0000________________000000000000000000000008______________________
_0000________________000000000000000000000008___000000000000000000_
_0000________________000000000000000000000008___000000000000000000_
_0000________________000000000000000000000000000000000000000000000_
_0000_______________________________000000000000000000008_____0000_
_0000_______________________________000000000000000000008__________
_0000_______________________________000000000000000000007__________
_0000_______________________________000000000000000000007_____0000_
_0000_______________________________000000000000000000000000000000_
_0000___________________________________________000000000000000000_
_0000___________________________________________000000000000000000_
_0000______________________________________________________________
___________________________________________________________________