0
0
________________________________
000000__________________________
000000_______________33333333333
000000_______________33333333333
000000_______________33333333333
000000_______________33333333333
000000_______________33555555533
000000_________________5555555__
000000__9999999999_____5555555__
000000__9999999999_____5555555__
000000__9999999999_____5555555__
000000__9999999999_____5555555__
000000222999992222222222222222__
000002222222222222222222222222__
000002222222222222222222222222__
000002222222222222222222222222__
000002222222222222222222222222__
000000222222222222222222222222__
000000_________________6666666__
000000_________________6666666__
000000_________________6666666__
000000_________________6666666__
000000_________________6666666__
000000_________________6666666__
000000_______________44666666644
000000_______________44444444444
000000_______________44444444444
000000_______________44444444444
000000_______________44444444444
000000__________________________
000000__________________________
000000_______________33333333333
000000_______________33333333333
000000_______________33333333333
000000_______________33333333333
000000_______________33555555533
000000_________________5555555__
000000__9999999999_____5555555__
000000__9999999999_____5555555__
000000__9999999999_____5555555__
000000__9999999999_____5555555__
000000222999992222222222222222__
000002222222222222222222222222__
000002222222222222222222222222__
000002222222222222222222222222__
000002222222222222222222222222__
000000222222222222222222222222__
000000_________________6666666__
000000_________________6666666__
000000_________________6666666__
000000_________________6666666__
000000_________________6666666__
000000_________________6666666__
000000_______________44666666644
000000_______________44444444444
000000_______________44444444444
000000_______________44444444444
000000_______________44444444444
000000__________________________
000000__________________________
000000_______________33333333333
000000_______________33333333333
000000_______________33333333333
000000_______________33333333333
000000_______________33555555533
000000_________________5555555__
000000__9999999999_____5555555__
000000__9999999999_____5555555__
000000__9999999999_____5555555__
000000__9999999999_____5555555__
000000222999992222222222222222__
000002222222222222222222222222__
000002222222222222222222222222__
000002222222222222222222222222__
000002222222222222222222222222__
000000222222222222222222222222__
000000_________________6666666__
000000_________________6666666__
000000_________________6666666__
000000_________________6666666__
000000_________________6666666__
000000_________________6666666__
000000_______________44666666644
000000_______________44444444444
000000_______________44444444444
000000_______________44444444444
000000_______________44444444444
000000__________________________
000000__________________________
000000_______________33333333333
000000_______________33333333333
000000_______________33333333333
000000_______________33333333333
000000_______________33555555533
000000_________________5555555__
000000__9999999999_____5555555__
000000__9999999999_____5555555__
000000__9999999999_____5555555__
000000__9999999999_____5555555__
000000222999992222222222222222__
000002222222222222222222222222__
000002222222222222222222222222__
000002222222222222222222222222__
000002222222222222222222222222__
000000222222222222222222222222__
000000_________________6666666__
000000_________________6666666__
000000_________________6666666__
000000_________________6666666__
000000_________________6666666__
000000_________________6666666__
000000_______________44666666644
000000_______________44444444444
000000_______________44444444444
000000_______________44444444444
000000_______________44444444444
000000__________________________
000000__________________________
000000_______________33333333333
000000_______________33333333333
000000_______________33333333333
000000_______________33333333333
000000_______________33555555533
000000_________________5555555__
000000__9999999999_____5555555__
000000__9999999999_____5555555__
000000__9999999999_____5555555__
000000__9999999999_____5555555__
000000222999992222222222222222__
000002222222222222222222222222__
000002222222222222222222222222__
000002222222222222222222222222__
000002222222222222222222222222__
000000222222222222222222222222__
000000_________________6666666__
000000_________________6666666__
000000_________________6666666__
000000_________________6666666__
000000_________________6666666__
000000_________________6666666__
000000_______________44666666644
000000_______________44444444444
000000_______________44444444444
000000_______________44444444444
000000_______________44444444444
000000__________________________
________________________________