0
0
_____________________........99999999__
000000_______________........99999999__
000000_______________........99999999__
000000_______________........99999999__
000000_______________........99999999__
000000_______________......____999999__
000000_______________......____999999__
000000_______________......____999999__
000000_______________......____999999__
000000_______________......____999999__
000000_______________8888888888888888__
000000_______________8888888888888888__
000000_______________8888888888888888__
000000_______________8888888888888888__
000000_______________8888833333388888__
000000____________________333333_______
000000__9999999999________333333_______
000000__9999999999________333333_______
000000__9999999999________333333_______
000000__9999999999________333333_______
000000111999991111111111111333311111111
000001111111111111111111111111111111111
000001111111111111111111111111111111111
000001111111111111111111111111111111111
000001111111111111111111111111111111111
000000111111111111111111111444411111111
000000____________________444444_______
000000____________________444444_______
000000____________________444444_______
000000____________________444444_______
000000____________________444444_______
000000_______________5555544444455555__
000000_______________5555555555555555__
000000_______________5555555555555555__
000000_______________5555555555555555__
000000_______________777777____666666__
000000_______________777777____666666__
000000_______________777777____666666__
000000_______________777777____666666__
000000_______________777777____666666__
000000_______________7777777766666666__
000000_______________7777777766666666__
000000_______________7777777766666666__
000000_______________7777777766666666__
000000_______________7777777766666666__
000000_______________........99999999__
000000_______________........99999999__
000000_______________........99999999__
000000_______________........99999999__
000000_______________........99999999__
000000_______________......____999999__
000000_______________......____999999__
000000_______________......____999999__
000000_______________......____999999__
000000_______________......____999999__
000000_______________8888888888888888__
000000_______________8888888888888888__
000000_______________8888888888888888__
000000_______________8888888888888888__
000000_______________8888833333388888__
000000____________________333333_______
000000__9999999999________333333_______
000000__9999999999________333333_______
000000__9999999999________333333_______
000000__9999999999________333333_______
000000111999991111111111111333311111111
000001111111111111111111111111111111111
000001111111111111111111111111111111111
000001111111111111111111111111111111111
000001111111111111111111111111111111111
000000111111111111111111111444411111111
000000____________________444444_______
000000____________________444444_______
000000____________________444444_______
000000____________________444444_______
000000____________________444444_______
000000_______________5555544444455555__
000000_______________5555555555555555__
000000_______________5555555555555555__
000000_______________5555555555555555__
000000_______________777777____666666__
000000_______________777777____666666__
000000_______________777777____666666__
000000_______________777777____666666__
000000_______________777777____666666__
000000_______________7777777766666666__
000000_______________7777777766666666__
000000_______________7777777766666666__
000000_______________7777777766666666__
000000_______________7777777766666666__
000000_______________........99999999__
000000_______________........99999999__
000000_______________........99999999__
000000_______________........99999999__
000000_______________........99999999__
000000_______________......____999999__
000000_______________......____999999__
000000_______________......____999999__
000000_______________......____999999__
000000_______________......____999999__
000000_______________8888888888888888__
000000_______________8888888888888888__
000000_______________8888888888888888__
000000_______________8888888888888888__
000000_______________8888833333388888__
000000____________________333333_______
000000__9999999999________333333_______
000000__9999999999________333333_______
000000__9999999999________333333_______
000000__9999999999________333333_______
000000111999991111111111111333311111111
000001111111111111111111111111111111111
000001111111111111111111111111111111111
000001111111111111111111111111111111111
000001111111111111111111111111111111111
000000111111111111111111111444411111111
000000____________________444444_______
000000____________________444444_______
000000____________________444444_______
000000____________________444444_______
000000____________________444444_______
000000_______________5555544444455555__
000000_______________5555555555555555__
000000_______________5555555555555555__
000000_______________5555555555555555__
000000_______________777777____666666__
000000_______________777777____666666__
000000_______________777777____666666__
000000_______________777777____666666__
000000_______________777777____666666__
000000_______________7777777766666666__
000000_______________7777777766666666__
000000_______________7777777766666666__
000000_______________7777777766666666__
000000_______________7777777766666666__
000000_______________........99999999__
000000_______________........99999999__
000000_______________........99999999__
000000_______________........99999999__
000000_______________........99999999__
000000_______________......____999999__
000000_______________......____999999__
000000_______________......____999999__
000000_______________......____999999__
000000_______________......____999999__
000000_______________8888888888888888__
000000_______________8888888888888888__
000000_______________8888888888888888__
000000_______________8888888888888888__
000000_______________8888833333388888__
000000____________________333333_______
000000__9999999999________333333_______
000000__9999999999________333333_______
000000__9999999999________333333_______
000000__9999999999________333333_______
000000111999991111111111111333311111111
000001111111111111111111111111111111111
000001111111111111111111111111111111111
000001111111111111111111111111111111111
000001111111111111111111111111111111111
000000111111111111111111111444411111111
000000____________________444444_______
000000____________________444444_______
000000____________________444444_______
000000____________________444444_______
000000____________________444444_______
000000_______________5555544444455555__
000000_______________5555555555555555__
000000_______________5555555555555555__
000000_______________5555555555555555__
000000_______________777777____666666__
000000_______________777777____666666__
000000_______________777777____666666__
000000_______________777777____666666__
000000_______________777777____666666__
000000_______________7777777766666666__
000000_______________7777777766666666__
000000_______________7777777766666666__
000000_______________7777777766666666__
000000_______________7777777766666666__
000000_______________........99999999__
000000_______________........99999999__
000000_______________........99999999__
000000_______________........99999999__
000000_______________........99999999__
000000_______________......____999999__
000000_______________......____999999__
000000_______________......____999999__
000000_______________......____999999__
000000_______________......____999999__
000000_______________8888888888888888__
000000_______________8888888888888888__
000000_______________8888888888888888__
000000_______________8888888888888888__
000000_______________8888833333388888__
000000____________________333333_______
000000__9999999999________333333_______
000000__9999999999________333333_______
000000__9999999999________333333_______
000000__9999999999________333333_______
000000111999991111111111111333311111111
000001111111111111111111111111111111111
000001111111111111111111111111111111111
000001111111111111111111111111111111111
000001111111111111111111111111111111111
000000111111111111111111111444411111111
000000____________________444444_______
000000____________________444444_______
000000____________________444444_______
000000____________________444444_______
000000____________________444444_______
000000_______________5555544444455555__
000000_______________5555555555555555__
000000_______________5555555555555555__
000000_______________5555555555555555__
000000_______________777777____666666__
000000_______________777777____666666__
000000_______________777777____666666__
000000_______________777777____666666__
000000_______________777777____666666__
000000_______________7777777766666666__
000000_______________7777777766666666__
000000_______________7777777766666666__
000000_______________7777777766666666__
_____________________7777777766666666__