0
0
______________________________________________________________
000000________________________________________________________
000000____________________.........333333333333333366666666666
000000____________________.........333333333333333366666666666
000000____________________.........333333333333333366666666666
000000_9999999999_________.........333333333333333366666666666
000000_9999999999_________.........333333333333333366666666666
000000_9999999999_________.........333333333333333366666666666
000000_9999999999_________.........333333333333333366666666666
000000119999911111111111111........_______________666666666666
000000111111111111111111111........_______________666666666666
000000111111111111111111111........___________________________
000000111111111111111111111........___________________________
000000111111111111111111111........_______________555555555555
000000111111111111111111111........_______________555555555555
000000____________________.........444444444444444455555555555
000000____________________.........444444444444444455555555555
000000____________________.........444444444444444455555555555
000000____________________.........444444444444444455555555555
000000____________________.........444444444444444455555555555
000000____________________.........444444444444444455555555555
000000____________________.........444444444444444455555555555
000000________________________________________________________
000000________________________________________________________
000000____________________.........333333333333333366666666666
000000____________________.........333333333333333366666666666
000000____________________.........333333333333333366666666666
000000_9999999999_________.........333333333333333366666666666
000000_9999999999_________.........333333333333333366666666666
000000_9999999999_________.........333333333333333366666666666
000000_9999999999_________.........333333333333333366666666666
000000119999911111111111111........_______________666666666666
000000111111111111111111111........_______________666666666666
000000111111111111111111111........___________________________
000000111111111111111111111........___________________________
000000111111111111111111111........_______________555555555555
000000111111111111111111111........_______________555555555555
000000____________________.........444444444444444455555555555
000000____________________.........444444444444444455555555555
000000____________________.........444444444444444455555555555
000000____________________.........444444444444444455555555555
000000____________________.........444444444444444455555555555
000000____________________.........444444444444444455555555555
000000____________________.........444444444444444455555555555
000000________________________________________________________
000000________________________________________________________
000000____________________.........333333333333333366666666666
000000____________________.........333333333333333366666666666
000000____________________.........333333333333333366666666666
000000_9999999999_________.........333333333333333366666666666
000000_9999999999_________.........333333333333333366666666666
000000_9999999999_________.........333333333333333366666666666
000000_9999999999_________.........333333333333333366666666666
000000119999911111111111111........_______________666666666666
000000111111111111111111111........_______________666666666666
000000111111111111111111111........___________________________
000000111111111111111111111........___________________________
000000111111111111111111111........_______________555555555555
000000111111111111111111111........_______________555555555555
000000____________________.........444444444444444455555555555
000000____________________.........444444444444444455555555555
000000____________________.........444444444444444455555555555
000000____________________.........444444444444444455555555555
000000____________________.........444444444444444455555555555
000000____________________.........444444444444444455555555555
000000____________________.........444444444444444455555555555
000000________________________________________________________
000000________________________________________________________
000000____________________.........333333333333333366666666666
000000____________________.........333333333333333366666666666
000000____________________.........333333333333333366666666666
000000_9999999999_________.........333333333333333366666666666
000000_9999999999_________.........333333333333333366666666666
000000_9999999999_________.........333333333333333366666666666
000000_9999999999_________.........333333333333333366666666666
000000119999911111111111111........_______________666666666666
000000111111111111111111111........_______________666666666666
000000111111111111111111111........___________________________
000000111111111111111111111........___________________________
000000111111111111111111111........_______________555555555555
000000111111111111111111111........_______________555555555555
000000____________________.........444444444444444455555555555
000000____________________.........444444444444444455555555555
000000____________________.........444444444444444455555555555
000000____________________.........444444444444444455555555555
000000____________________.........444444444444444455555555555
000000____________________.........444444444444444455555555555
000000____________________.........444444444444444455555555555
000000________________________________________________________
000000________________________________________________________
000000____________________.........333333333333333366666666666
000000____________________.........333333333333333366666666666
000000____________________.........333333333333333366666666666
000000_9999999999_________.........333333333333333366666666666
000000_9999999999_________.........333333333333333366666666666
000000_9999999999_________.........333333333333333366666666666
000000_9999999999_________.........333333333333333366666666666
000000119999911111111111111........_______________666666666666
000000111111111111111111111........_______________666666666666
000000111111111111111111111........___________________________
000000111111111111111111111........___________________________
000000111111111111111111111........_______________555555555555
000000111111111111111111111........_______________555555555555
000000____________________.........444444444444444455555555555
000000____________________.........444444444444444455555555555
000000____________________.........444444444444444455555555555
000000____________________.........444444444444444455555555555
000000____________________.........444444444444444455555555555
000000____________________.........444444444444444455555555555
000000____________________.........444444444444444455555555555
000000________________________________________________________
______________________________________________________________