0
0
_____________________________________
_____________33333333333_____________
_____________33333333333_____________
_____________33333333333_____________
_____________33333333333_____________
_____________33333333333_____________
_____________33333333333_____________
_____________33333333333_____________
8888888888333333333333333337777777777
8888888888333333333333333337777777777
8888888888333333333333333337777777777
8888888888333333333333333337777777777
8888888888333355555555533337777777777
8888888888333355555555533337777777777
8888888888333355555555533337777777777
8888888888333355555555533337777777777
8888888888333355555555533337777777777
8888888888333335555555333337777777777
8888888888333333333333333337777777777
8888888888333333333333333337777777777
8888888888333333333333333337777777777
_____________33333333333_____________
_____________33333333333_____________
_____________33333333333_____________
_____________33333333333_____________
_____________33333333333_____________
_____________33333333333_____________
_____________33333333333_____________
_____________33333333333_____________
_____________33333333333_____________
_____________33333333333_____________
_____________33333333333_____________
_____________33333333333_____________
_____________33333333333_____________
_____________33333333333_____________
_____________33333333333_____________
_____________33333333333_____________
8888888888333333333333333337777777777
8888888888333333333333333337777777777
8888888888333333333333333337777777777
8888888888333333333333333337777777777
8888888888333355555555533337777777777
8888888888333355555555533337777777777
8888888888333355555555533337777777777
8888888888333355555555533337777777777
8888888888333355555555533337777777777
8888888888333335555555333337777777777
8888888888333333333333333337777777777
8888888888333333333333333337777777777
8888888888333333333333333337777777777
_____________33333333333_____________
_____________33333333333_____________
_____________33333333333_____________
_____________33333333333_____________
_____________33333333333_____________
_____________33333333333_____________
_____________33333333333_____________
_____________33333333333_____________
_____________33333333333_____________
_____________33333333333_____________
_____________33333333333_____________
_____________33333333333_____________
_____________33333333333_____________
_____________33333333333_____________
_____________33333333333_____________
_____________33333333333_____________
8888888888333333333333333337777777777
8888888888333333333333333337777777777
8888888888333333333333333337777777777
8888888888333333333333333337777777777
8888888888333355555555533337777777777
8888888888333355555555533337777777777
8888888888333355555555533337777777777
8888888888333355555555533337777777777
8888888888333355555555533337777777777
8888888888333335555555333337777777777
8888888888333333333333333337777777777
8888888888333333333333333337777777777
8888888888333333333333333337777777777
_____________33333333333_____________
_____________33333333333_____________
_____________33333333333_____________
_____________33333333333_____________
_____________33333333333_____________
_____________33333333333_____________
_____________33333333333_____________
_____________33333333333_____________
_____________33333333333_____________
_____________33333333333_____________
_____________33333333333_____________
_____________33333333333_____________
_____________33333333333_____________
_____________33333333333_____________
_____________33333333333_____________
_____________33333333333_____________
8888888888333333333333333337777777777
8888888888333333333333333337777777777
8888888888333333333333333337777777777
8888888888333333333333333337777777777
8888888888333355555555533337777777777
8888888888333355555555533337777777777
8888888888333355555555533337777777777
8888888888333355555555533337777777777
8888888888333355555555533337777777777
8888888888333335555555333337777777777
8888888888333333333333333337777777777
8888888888333333333333333337777777777
8888888888333333333333333337777777777
_____________33333333333_____________
_____________33333333333_____________
_____________33333333333_____________
_____________33333333333_____________
_____________33333333333_____________
_____________33333333333_____________
_____________33333333333_____________
_____________33333333333_____________
_____________33333333333_____________
_____________33333333333_____________
_____________33333333333_____________
_____________33333333333_____________
_____________33333333333_____________
_____________33333333333_____________
_____________33333333333_____________
_____________33333333333_____________
8888888888333333333333333337777777777
8888888888333333333333333337777777777
8888888888333333333333333337777777777
8888888888333333333333333337777777777
8888888888333355555555533337777777777
8888888888333355555555533337777777777
8888888888333355555555533337777777777
8888888888333355555555533337777777777
8888888888333355555555533337777777777
8888888888333335555555333337777777777
8888888888333333333333333337777777777
8888888888333333333333333337777777777
8888888888333333333333333337777777777
_____________33333333333_____________
_____________33333333333_____________
_____________33333333333_____________
_____________33333333333_____________
_____________33333333333_____________
_____________33333333333_____________
_____________33333333333_____________
_____________33333333333_____________
_____________33333333333_____________
_____________33333333333_____________
_____________33333333333_____________
_____________33333333333_____________
_____________33333333333_____________
_____________33333333333_____________
_____________33333333333_____________
_____________________________________