0
0
____________________________________________________________
111111___________________3333333333333333_6666666666666666__
111111___________________3333333333333333_6666666666666666__
111111___________________3333333333333333_6666666666666666__
111111___________________3333333333333333_6666666666666666__
111111__99999999999______3333333333333333_6666666666666666__
111111__99999999999______3333333333333333_6666666666666666__
111111__99999999999______3333333333333333_6666666666666666__
111111__99999999999______3333333333333333_6666666666666666__
111111222999992222222222222222233332222222222222666622222222
111112222222222222222222222222222222222222222222222222222222
111112222222222222222222222222222222222222222222222222222222
111112222222222222222222222222222222222222222222222222222222
111112222222222222222222222222222222222222222222222222222222
111111222222222222222222222222244442222222222222555522222222
111111___________________4444444444444444_5555555555555555__
111111___________________4444444444444444_5555555555555555__
111111___________________4444444444444444_5555555555555555__
111111___________________4444444444444444_5555555555555555__
111111___________________4444444444444444_5555555555555555__
111111___________________4444444444444444_5555555555555555__
111111___________________4444444444444444_5555555555555555__
111111___________________4444444444444444_5555555555555555__
111111______________________________________________________
111111______________________________________________________
111111___________________3333333333333333_6666666666666666__
111111___________________3333333333333333_6666666666666666__
111111___________________3333333333333333_6666666666666666__
111111___________________3333333333333333_6666666666666666__
111111__99999999999______3333333333333333_6666666666666666__
111111__99999999999______3333333333333333_6666666666666666__
111111__99999999999______3333333333333333_6666666666666666__
111111__99999999999______3333333333333333_6666666666666666__
111111222999992222222222222222233332222222222222666622222222
111112222222222222222222222222222222222222222222222222222222
111112222222222222222222222222222222222222222222222222222222
111112222222222222222222222222222222222222222222222222222222
111112222222222222222222222222222222222222222222222222222222
111111222222222222222222222222244442222222222222555522222222
111111___________________4444444444444444_5555555555555555__
111111___________________4444444444444444_5555555555555555__
111111___________________4444444444444444_5555555555555555__
111111___________________4444444444444444_5555555555555555__
111111___________________4444444444444444_5555555555555555__
111111___________________4444444444444444_5555555555555555__
111111___________________4444444444444444_5555555555555555__
111111___________________4444444444444444_5555555555555555__
111111______________________________________________________
111111______________________________________________________
111111___________________3333333333333333_6666666666666666__
111111___________________3333333333333333_6666666666666666__
111111___________________3333333333333333_6666666666666666__
111111___________________3333333333333333_6666666666666666__
111111__99999999999______3333333333333333_6666666666666666__
111111__99999999999______3333333333333333_6666666666666666__
111111__99999999999______3333333333333333_6666666666666666__
111111__99999999999______3333333333333333_6666666666666666__
111111222999992222222222222222233332222222222222666622222222
111112222222222222222222222222222222222222222222222222222222
111112222222222222222222222222222222222222222222222222222222
111112222222222222222222222222222222222222222222222222222222
111112222222222222222222222222222222222222222222222222222222
111111222222222222222222222222244442222222222222555522222222
111111___________________4444444444444444_5555555555555555__
111111___________________4444444444444444_5555555555555555__
111111___________________4444444444444444_5555555555555555__
111111___________________4444444444444444_5555555555555555__
111111___________________4444444444444444_5555555555555555__
111111___________________4444444444444444_5555555555555555__
111111___________________4444444444444444_5555555555555555__
111111___________________4444444444444444_5555555555555555__
111111______________________________________________________
111111______________________________________________________
111111___________________3333333333333333_6666666666666666__
111111___________________3333333333333333_6666666666666666__
111111___________________3333333333333333_6666666666666666__
111111___________________3333333333333333_6666666666666666__
111111__99999999999______3333333333333333_6666666666666666__
111111__99999999999______3333333333333333_6666666666666666__
111111__99999999999______3333333333333333_6666666666666666__
111111__99999999999______3333333333333333_6666666666666666__
111111222999992222222222222222233332222222222222666622222222
111112222222222222222222222222222222222222222222222222222222
111112222222222222222222222222222222222222222222222222222222
111112222222222222222222222222222222222222222222222222222222
111112222222222222222222222222222222222222222222222222222222
111111222222222222222222222222244442222222222222555522222222
111111___________________4444444444444444_5555555555555555__
111111___________________4444444444444444_5555555555555555__
111111___________________4444444444444444_5555555555555555__
111111___________________4444444444444444_5555555555555555__
111111___________________4444444444444444_5555555555555555__
111111___________________4444444444444444_5555555555555555__
111111___________________4444444444444444_5555555555555555__
111111___________________4444444444444444_5555555555555555__
111111______________________________________________________
111111______________________________________________________
111111___________________3333333333333333_6666666666666666__
111111___________________3333333333333333_6666666666666666__
111111___________________3333333333333333_6666666666666666__
111111___________________3333333333333333_6666666666666666__
111111__99999999999______3333333333333333_6666666666666666__
111111__99999999999______3333333333333333_6666666666666666__
111111__99999999999______3333333333333333_6666666666666666__
111111__99999999999______3333333333333333_6666666666666666__
111111222999992222222222222222233332222222222222666622222222
111112222222222222222222222222222222222222222222222222222222
111112222222222222222222222222222222222222222222222222222222
111112222222222222222222222222222222222222222222222222222222
111112222222222222222222222222222222222222222222222222222222
111111222222222222222222222222244442222222222222555522222222
111111___________________4444444444444444_5555555555555555__
111111___________________4444444444444444_5555555555555555__
111111___________________4444444444444444_5555555555555555__
111111___________________4444444444444444_5555555555555555__
111111___________________4444444444444444_5555555555555555__
111111___________________4444444444444444_5555555555555555__
111111___________________4444444444444444_5555555555555555__
111111___________________4444444444444444_5555555555555555__
111111______________________________________________________
____________________________________________________________