54
129
____________________________________________000000000_
_1111111111111______________________________000000000_
_1111111111111______________________________000000000_
_1111111111111______________________________000000000_
_1111111111111______________________________000000000_
_1111111111111222222222222222222222222222222000000000_
_1111111111111222222222222222222222222222222000000000_
_1111111111111222222222222222222222222222222000000000_
_1111111111111222222222222222222222222222222000000000_
_1111111111111222222222222222222222222222222000000000_
_1111111111111____________________33333_____000000000_
_1111111111111____________________33333_____000000000_
_1111111111111____________________33333_____000000000_
_1111111111111____________________33333_____000000000_
__________________________________33333_____000000000_
_5555555555555555555555555555_____33333_____000000000_
_5555555555555555555555555555_____33333_____000000000_
_5555555555555555555555555555_____33333_____000000000_
_5555555555555555555555555555_____33333_____000000000_
_55555555555555555555555555554444444444_____000000000_
_55555555555555555555555555554444444444_____000000000_
_55555555555555555555555555554444444444_____000000000_
_55555555555555555555555555554444444444_____000000000_
_55555555555555555555555555554444444444_____000000000_
_5555555555555555555555555555_______________000000000_
_5555555555555555555555555555_______________000000000_
_5555555555555555555555555555_______________000000000_
_5555555555555555555555555555_______________000000000_
____________________________________________000000000_
_6666666666666______________________________000000000_
_6666666666666______________________________000000000_
_6666666666666______________________________000000000_
_6666666666666______________________________000000000_
_6666666666666777777777777777777777777777777000000000_
_6666666666666777777777777777777777777777777000000000_
_6666666666666777777777777777777777777777777000000000_
_6666666666666777777777777777777777777777777000000000_
_6666666666666777777777777777777777777777777000000000_
_6666666666666____________________88888_____000000000_
_6666666666666____________________88888_____000000000_
_6666666666666____________________88888_____000000000_
_6666666666666____________________88888_____000000000_
__________________________________88888_____000000000_
_::::::::::::::::::::::::::::_____88888_____000000000_
_::::::::::::::::::::::::::::_____88888_____000000000_
_::::::::::::::::::::::::::::_____88888_____000000000_
_::::::::::::::::::::::::::::_____88888_____000000000_
_::::::::::::::::::::::::::::9999999999_____000000000_
_::::::::::::::::::::::::::::9999999999_____000000000_
_::::::::::::::::::::::::::::9999999999_____000000000_
_::::::::::::::::::::::::::::9999999999_____000000000_
_::::::::::::::::::::::::::::9999999999_____000000000_
_::::::::::::::::::::::::::::_______________000000000_
_::::::::::::::::::::::::::::_______________000000000_
_::::::::::::::::::::::::::::_______________000000000_
_::::::::::::::::::::::::::::_______________000000000_
____________________________________________000000000_
_;;;;;;;;;;;;;______________________________000000000_
_;;;;;;;;;;;;;______________________________000000000_
_;;;;;;;;;;;;;______________________________000000000_
_;;;;;;;;;;;;;______________________________000000000_
_;;;;;;;;;;;;;<<<<<<<<<<<<<<<<<<<<<<<<<<<<<<000000000_
_;;;;;;;;;;;;;<<<<<<<<<<<<<<<<<<<<<<<<<<<<<<000000000_
_;;;;;;;;;;;;;<<<<<<<<<<<<<<<<<<<<<<<<<<<<<<000000000_
_;;;;;;;;;;;;;<<<<<<<<<<<<<<<<<<<<<<<<<<<<<<000000000_
_;;;;;;;;;;;;;<<<<<<<<<<<<<<<<<<<<<<<<<<<<<<000000000_
_;;;;;;;;;;;;;____________________=====_____000000000_
_;;;;;;;;;;;;;____________________=====_____000000000_
_;;;;;;;;;;;;;____________________=====_____000000000_
_;;;;;;;;;;;;;____________________=====_____000000000_
__________________________________=====_____000000000_
_????????????????????????????_____=====_____000000000_
_????????????????????????????_____=====_____000000000_
_????????????????????????????_____=====_____000000000_
_????????????????????????????_____=====_____000000000_
_????????????????????????????>>>>>>>>>>_____000000000_
_????????????????????????????>>>>>>>>>>_____000000000_
_????????????????????????????>>>>>>>>>>_____000000000_
_????????????????????????????>>>>>>>>>>_____000000000_
_????????????????????????????>>>>>>>>>>_____000000000_
_????????????????????????????_______________000000000_
_????????????????????????????_______________000000000_
_????????????????????????????_______________000000000_
_????????????????????????????_______________000000000_
____________________________________________000000000_
_@@@@@@@@@@@@@______________________________000000000_
_@@@@@@@@@@@@@______________________________000000000_
_@@@@@@@@@@@@@______________________________000000000_
_@@@@@@@@@@@@@______________________________000000000_
_@@@@@@@@@@@@@AAAAAAAAAAAAAAAAAAAAAAAAAAAAAA000000000_
_@@@@@@@@@@@@@AAAAAAAAAAAAAAAAAAAAAAAAAAAAAA000000000_
_@@@@@@@@@@@@@AAAAAAAAAAAAAAAAAAAAAAAAAAAAAA000000000_
_@@@@@@@@@@@@@AAAAAAAAAAAAAAAAAAAAAAAAAAAAAA000000000_
_@@@@@@@@@@@@@AAAAAAAAAAAAAAAAAAAAAAAAAAAAAA000000000_
_@@@@@@@@@@@@@____________________BBBBB_____000000000_
_@@@@@@@@@@@@@____________________BBBBB_____000000000_
_@@@@@@@@@@@@@____________________BBBBB_____000000000_
_@@@@@@@@@@@@@____________________BBBBB_____000000000_
__________________________________BBBBB_____000000000_
_DDDDDDDDDDDDDDDDDDDDDDDDDDDD_____BBBBB_____000000000_
_DDDDDDDDDDDDDDDDDDDDDDDDDDDD_____BBBBB_____000000000_
_DDDDDDDDDDDDDDDDDDDDDDDDDDDD_____BBBBB_____000000000_
_DDDDDDDDDDDDDDDDDDDDDDDDDDDD_____BBBBB_____000000000_
_DDDDDDDDDDDDDDDDDDDDDDDDDDDDCCCCCCCCCC_____000000000_
_DDDDDDDDDDDDDDDDDDDDDDDDDDDDCCCCCCCCCC_____000000000_
_DDDDDDDDDDDDDDDDDDDDDDDDDDDDCCCCCCCCCC_____000000000_
_DDDDDDDDDDDDDDDDDDDDDDDDDDDDCCCCCCCCCC_____000000000_
_DDDDDDDDDDDDDDDDDDDDDDDDDDDDCCCCCCCCCC_____000000000_
_DDDDDDDDDDDDDDDDDDDDDDDDDDDD_______________000000000_
_DDDDDDDDDDDDDDDDDDDDDDDDDDDD_______________000000000_
_DDDDDDDDDDDDDDDDDDDDDDDDDDDD_______________000000000_
_DDDDDDDDDDDDDDDDDDDDDDDDDDDD_______________000000000_
____________________________________________000000000_
_EEEEEEEEEEEEE______________________________000000000_
_EEEEEEEEEEEEE______________________________000000000_
_EEEEEEEEEEEEE______________________________000000000_
_EEEEEEEEEEEEE______________________________000000000_
_EEEEEEEEEEEEEFFFFFFFFFFFFFFFFFFFFFFFFFFFFFF000000000_
_EEEEEEEEEEEEEFFFFFFFFFFFFFFFFFFFFFFFFFFFFFF000000000_
_EEEEEEEEEEEEEFFFFFFFFFFFFFFFFFFFFFFFFFFFFFF000000000_
_EEEEEEEEEEEEEFFFFFFFFFFFFFFFFFFFFFFFFFFFFFF000000000_
_EEEEEEEEEEEEEFFFFFFFFFFFFFFFFFFFFFFFFFFFFFF000000000_
_EEEEEEEEEEEEE____________________GGGGG_____000000000_
_EEEEEEEEEEEEE____________________GGGGG_____000000000_
_EEEEEEEEEEEEE____________________GGGGG_____000000000_
_EEEEEEEEEEEEE____________________GGGGG_____000000000_
__________________________________GGGGG_____000000000_
_IIIIIIIIIIIIIIIIIIIIIIIIIIII_____GGGGG_____000000000_
_IIIIIIIIIIIIIIIIIIIIIIIIIIII_____GGGGG_____000000000_
_IIIIIIIIIIIIIIIIIIIIIIIIIIII_____GGGGG_____000000000_
_IIIIIIIIIIIIIIIIIIIIIIIIIIII_____GGGGG_____000000000_
_IIIIIIIIIIIIIIIIIIIIIIIIIIIIHHHHHHHHHH_____000000000_
_IIIIIIIIIIIIIIIIIIIIIIIIIIIIHHHHHHHHHH_____000000000_
_IIIIIIIIIIIIIIIIIIIIIIIIIIIIHHHHHHHHHH_____000000000_
_IIIIIIIIIIIIIIIIIIIIIIIIIIIIHHHHHHHHHH_____000000000_
_IIIIIIIIIIIIIIIIIIIIIIIIIIIIHHHHHHHHHH_____000000000_
_IIIIIIIIIIIIIIIIIIIIIIIIIIII_______________000000000_
_IIIIIIIIIIIIIIIIIIIIIIIIIIII_______________000000000_
_IIIIIIIIIIIIIIIIIIIIIIIIIIII_______________000000000_
_IIIIIIIIIIIIIIIIIIIIIIIIIIII_______________000000000_