29
211
___________________111111111_
_0000000000000_____111111111_
_0000000000000_____111111111_
_0000000000000_____111111111_
_0000000000000_____111111111_
_000000000000000011111111111_
_000000000000000011111111111_
_000000000000000011111111111_
_000000000000000011111111111_
_000000000000000011111111111_
_0000000000000_____111111111_
_0000000000000_____111111111_
_0000000000000_____111111111_
_0000000000000_____111111111_
___________________111111111_
___________________111111111_
___________________111111111_
___________________111111111_
___________________111111111_
___________________111111111_
___________________111111111_
_2222222222222_____111111111_
_2222222222222_____111111111_
_2222222222222_____111111111_
_2222222222222_____111111111_
_222222222222222211111111111_
_222222222222222211111111111_
_222222222222222211111111111_
_222222222222222211111111111_
_222222222222222211111111111_
_2222222222222_____111111111_
_2222222222222_____111111111_
_2222222222222_____111111111_
_2222222222222_____111111111_
___________________111111111_
___________________111111111_
___________________111111111_
___________________111111111_
___________________111111111_
___________________111111111_
___________________111111111_
_3333333333333_____111111111_
_3333333333333_____111111111_
_3333333333333_____111111111_
_3333333333333_____111111111_
_333333333333333311111111111_
_333333333333333311111111111_
_333333333333333311111111111_
_333333333333333311111111111_
_333333333333333311111111111_
_3333333333333_____111111111_
_3333333333333_____111111111_
_3333333333333_____111111111_
_3333333333333_____111111111_
___________________111111111_
___________________111111111_
___________________111111111_
___________________111111111_
___________________111111111_
___________________111111111_
___________________111111111_
_4444444444444_____111111111_
_4444444444444_____111111111_
_4444444444444_____111111111_
_4444444444444_____111111111_
_444444444444444411111111111_
_444444444444444411111111111_
_444444444444444411111111111_
_444444444444444411111111111_
_444444444444444411111111111_
_4444444444444_____111111111_
_4444444444444_____111111111_
_4444444444444_____111111111_
_4444444444444_____111111111_
___________________111111111_
___________________111111111_
___________________111111111_
___________________111111111_
___________________111111111_
___________________111111111_
___________________111111111_
_5555555555555_____111111111_
_5555555555555_____111111111_
_5555555555555_____111111111_
_5555555555555_____111111111_
_555555555555555511111111111_
_555555555555555511111111111_
_555555555555555511111111111_
_555555555555555511111111111_
_555555555555555511111111111_
_5555555555555_____111111111_
_5555555555555_____111111111_
_5555555555555_____111111111_
_5555555555555_____111111111_
___________________111111111_
___________________111111111_
___________________111111111_
___________________111111111_
___________________111111111_
___________________111111111_
___________________111111111_
_6666666666666_____111111111_
_6666666666666_____111111111_
_6666666666666_____111111111_
_6666666666666_____111111111_
_666666666666666611111111111_
_666666666666666611111111111_
_666666666666666611111111111_
_666666666666666611111111111_
_666666666666666611111111111_
_6666666666666_____111111111_
_6666666666666_____111111111_
_6666666666666_____111111111_
_6666666666666_____111111111_
___________________111111111_
___________________111111111_
___________________111111111_
___________________111111111_
___________________111111111_
___________________111111111_
___________________111111111_
_7777777777777_____111111111_
_7777777777777_____111111111_
_7777777777777_____111111111_
_7777777777777_____111111111_
_777777777777777711111111111_
_777777777777777711111111111_
_777777777777777711111111111_
_777777777777777711111111111_
_777777777777777711111111111_
_7777777777777_____111111111_
_7777777777777_____111111111_
_7777777777777_____111111111_
_7777777777777_____111111111_
___________________111111111_
___________________111111111_
___________________111111111_
___________________111111111_
___________________111111111_
___________________111111111_
___________________111111111_
_8888888888888_____111111111_
_8888888888888_____111111111_
_8888888888888_____111111111_
_8888888888888_____111111111_
_888888888888888811111111111_
_888888888888888811111111111_
_888888888888888811111111111_
_888888888888888811111111111_
_888888888888888811111111111_
_8888888888888_____111111111_
_8888888888888_____111111111_
_8888888888888_____111111111_
_8888888888888_____111111111_
___________________111111111_
___________________111111111_
___________________111111111_
___________________111111111_
___________________111111111_
___________________111111111_
___________________111111111_
_9999999999999_____111111111_
_9999999999999_____111111111_
_9999999999999_____111111111_
_9999999999999_____111111111_
_999999999999999911111111111_
_999999999999999911111111111_
_999999999999999911111111111_
_999999999999999911111111111_
_999999999999999911111111111_
_9999999999999_____111111111_
_9999999999999_____111111111_
_9999999999999_____111111111_
_9999999999999_____111111111_
___________________111111111_
___________________111111111_
___________________111111111_
___________________111111111_
___________________111111111_
___________________111111111_
___________________111111111_
_:::::::::::::_____111111111_
_:::::::::::::_____111111111_
_:::::::::::::_____111111111_
_:::::::::::::_____111111111_
_::::::::::::::::11111111111_
_::::::::::::::::11111111111_
_::::::::::::::::11111111111_
_::::::::::::::::11111111111_
_::::::::::::::::11111111111_
_:::::::::::::_____111111111_
_:::::::::::::_____111111111_
_:::::::::::::_____111111111_
_:::::::::::::_____111111111_
___________________111111111_
___________________111111111_
___________________111111111_
___________________111111111_
___________________111111111_
___________________111111111_
