34
90
_000000000________________________
_000000000_____33333_22222_111111_
_000000000_____33333_22222_111111_
_000000000_____33333_22222_111111_
_000000000_____33333_22222_111111_
_000000000_____AA_______AA_AA_____
_000000000AAAAAAAAAAAAAAAAAAA_444_
_000000000AAAAAAAAAAAAAAAAAAA_444_
_000000000AAAAAAAAAAAAAAAAAAA_444_
_000000000_____AAAAAAAAAAAAAA_444_
_000000000_____AAAAAAAAAAAAAA_444_
_000000000_____AAAAAAAAAAAAAAAAAA_
_000000000_____AAAAAAAAAAAAAAAAAA_
_000000000_____AAAAAAAAAAAAAAAAAA_
_000000000________________________
_000000000________________________
_000000000________________________
_000000000________________________
_000000000________________________
_000000000_____00000_00000_000000_
_000000000_____00000_00000_000000_
_000000000_____00000_00000_000000_
_000000000_____00000_00000_000000_
_000000000_____77_______77_77_____
_0000000007777777777777777777_BBB_
_0000000007777777777777777777_BBB_
_0000000007777777777777777777_BBB_
_000000000_____77777777777777_BBB_
_000000000_____77777777777777_BBB_
_000000000_____777777777777777777_
_000000000_____777777777777777777_
_000000000_____777777777777777777_
_000000000________________________
_000000000________________________
_000000000________________________
_000000000________________________
_000000000________________________
_000000000_____00000_00000_000000_
_000000000_____00000_00000_000000_
_000000000_____00000_00000_000000_
_000000000_____00000_00000_000000_
_000000000_____88_______88_88_____
_0000000008888888888888888888_CCC_
_0000000008888888888888888888_CCC_
_0000000008888888888888888888_CCC_
_000000000_____88888888888888_CCC_
_000000000_____88888888888888_CCC_
_000000000_____888888888888888888_
_000000000_____888888888888888888_
_000000000_____888888888888888888_
_000000000________________________
_000000000________________________
_000000000________________________
_000000000________________________
_000000000________________________
_000000000_____00000_00000_000000_
_000000000_____00000_00000_000000_
_000000000_____00000_00000_000000_
_000000000_____00000_00000_000000_
_000000000_____99_______99_99_____
_0000000009999999999999999999_DDD_
_0000000009999999999999999999_DDD_
_0000000009999999999999999999_DDD_
_000000000_____99999999999999_DDD_
_000000000_____99999999999999_DDD_
_000000000_____999999999999999999_
_000000000_____999999999999999999_
_000000000_____999999999999999999_
_000000000________________________
_000000000________________________
_000000000________________________
_000000000________________________
_000000000________________________
_000000000_____00000_00000_000000_
_000000000_____00000_00000_000000_
_000000000_____00000_00000_000000_
_000000000_____00000_00000_000000_
_000000000_____AA_______AA_AA_____
_000000000AAAAAAAAAAAAAAAAAAA_EEE_
_000000000AAAAAAAAAAAAAAAAAAA_EEE_
_000000000AAAAAAAAAAAAAAAAAAA_EEE_
_000000000_____AAAAAAAAAAAAAA_EEE_
_000000000_____AAAAAAAAAAAAAA_EEE_
_000000000_____AAAAAAAAAAAAAAAAAA_
_000000000_____AAAAAAAAAAAAAAAAAA_
_000000000_____AAAAAAAAAAAAAAAAAA_
_000000000________________________
_000000000________________________
_000000000________________________
_000000000________________________
