29
100
_000000000___________________
_000000000_____1111111111111_
_000000000_____1111111111111_
_000000000_____1111111111111_
_000000000_____1111111111111_
_000000000_____1111_11111111_
_000000000_____1111_11111111_
_000000000000000000_11111111_
_000000000000000000_11111111_
_000000000000000000__________
_000000000000000000__________
_000000000000000000_66666666_
_000000000000000000_66666666_
_000000000_____6666_66666666_
_000000000_____6666_66666666_
_000000000_____6666666666666_
_000000000_____6666666666666_
_000000000_____6666666666666_
_000000000_____6666666666666_
_000000000___________________
_000000000___________________
_000000000_____2222222222222_
_000000000_____2222222222222_
_000000000_____2222222222222_
_000000000_____2222222222222_
_000000000_____2222_22222222_
_000000000_____2222_22222222_
_000000000000000000_22222222_
_000000000000000000_22222222_
_000000000000000000__________
_000000000000000000__________
_000000000000000000_77777777_
_000000000000000000_77777777_
_000000000_____7777_77777777_
_000000000_____7777_77777777_
_000000000_____7777777777777_
_000000000_____7777777777777_
_000000000_____7777777777777_
_000000000_____7777777777777_
_000000000___________________
_000000000___________________
_000000000_____3333333333333_
_000000000_____3333333333333_
_000000000_____3333333333333_
_000000000_____3333333333333_
_000000000_____3333_33333333_
_000000000_____3333_33333333_
_000000000000000000_33333333_
_000000000000000000_33333333_
_000000000000000000__________
_000000000000000000__________
_000000000000000000_88888888_
_000000000000000000_88888888_
_000000000_____8888_88888888_
_000000000_____8888_88888888_
_000000000_____8888888888888_
_000000000_____8888888888888_
_000000000_____8888888888888_
_000000000_____8888888888888_
_000000000___________________
_000000000___________________
_000000000_____4444444444444_
_000000000_____4444444444444_
_000000000_____4444444444444_
_000000000_____4444444444444_
_000000000_____4444_44444444_
_000000000_____4444_44444444_
_000000000000000000_44444444_
_000000000000000000_44444444_
_000000000000000000__________
_000000000000000000__________
_000000000000000000_99999999_
_000000000000000000_99999999_
_000000000_____9999_99999999_
_000000000_____9999_99999999_
_000000000_____9999999999999_
_000000000_____9999999999999_
_000000000_____9999999999999_
_000000000_____9999999999999_
_000000000___________________
_000000000___________________
_000000000_____5555555555555_
_000000000_____5555555555555_
_000000000_____5555555555555_
_000000000_____5555555555555_
_000000000_____5555_55555555_
_000000000_____5555_55555555_
_000000000000000000_55555555_
_000000000000000000_55555555_
_000000000000000000__________
_000000000000000000__________
_000000000000000000_::::::::_
_000000000000000000_::::::::_
_000000000_____::::_::::::::_
_000000000_____::::_::::::::_
_000000000_____:::::::::::::_
_000000000_____:::::::::::::_
_000000000_____:::::::::::::_
_000000000_____:::::::::::::_
_000000000___________________
