29
200
_111111111___________________
_111111111_____0000000000000_
_111111111_____0000000000000_
_111111111_____0000000000000_
_111111111_____0000000000000_
_111111111110000000000000000_
_111111111110000000000000000_
_111111111110000000000000000_
_111111111110000000000000000_
_111111111110000000000000000_
_111111111_____0000000000000_
_111111111_____0000000000000_
_111111111_____0000000000000_
_111111111_____0000000000000_
_111111111___________________
_111111111___________________
_111111111___________________
_111111111___________________
_111111111___________________
_111111111___________________
_111111111___________________
_111111111_____2222222222222_
_111111111_____2222222222222_
_111111111_____2222222222222_
_111111111_____2222222222222_
_111111111112222222222222222_
_111111111112222222222222222_
_111111111112222222222222222_
_111111111112222222222222222_
_111111111112222222222222222_
_111111111_____2222222222222_
_111111111_____2222222222222_
_111111111_____2222222222222_
_111111111_____2222222222222_
_111111111___________________
_111111111___________________
_111111111___________________
_111111111___________________
_111111111___________________
_111111111___________________
_111111111___________________
_111111111_____3333333333333_
_111111111_____3333333333333_
_111111111_____3333333333333_
_111111111_____3333333333333_
_111111111113333333333333333_
_111111111113333333333333333_
_111111111113333333333333333_
_111111111113333333333333333_
_111111111113333333333333333_
_111111111_____3333333333333_
_111111111_____3333333333333_
_111111111_____3333333333333_
_111111111_____3333333333333_
_111111111___________________
_111111111___________________
_111111111___________________
_111111111___________________
_111111111___________________
_111111111___________________
_111111111___________________
_111111111_____4444444444444_
_111111111_____4444444444444_
_111111111_____4444444444444_
_111111111_____4444444444444_
_111111111114444444444444444_
_111111111114444444444444444_
_111111111114444444444444444_
_111111111114444444444444444_
_111111111114444444444444444_
_111111111_____4444444444444_
_111111111_____4444444444444_
_111111111_____4444444444444_
_111111111_____4444444444444_
_111111111___________________
_111111111___________________
_111111111___________________
_111111111___________________
_111111111___________________
_111111111___________________
_111111111___________________
_111111111_____5555555555555_
_111111111_____5555555555555_
_111111111_____5555555555555_
_111111111_____5555555555555_
_111111111115555555555555555_
_111111111115555555555555555_
_111111111115555555555555555_
_111111111115555555555555555_
_111111111115555555555555555_
_111111111_____5555555555555_
_111111111_____5555555555555_
_111111111_____5555555555555_
_111111111_____5555555555555_
_111111111___________________
_111111111___________________
_111111111___________________
_111111111___________________
_111111111___________________
_111111111___________________
_111111111___________________
_111111111_____6666666666666_
_111111111_____6666666666666_
_111111111_____6666666666666_
_111111111_____6666666666666_
_111111111116666666666666666_
_111111111116666666666666666_
_111111111116666666666666666_
_111111111116666666666666666_
_111111111116666666666666666_
_111111111_____6666666666666_
_111111111_____6666666666666_
_111111111_____6666666666666_
_111111111_____6666666666666_
_111111111___________________
_111111111___________________
_111111111___________________
_111111111___________________
_111111111___________________
_111111111___________________
_111111111___________________
_111111111_____7777777777777_
_111111111_____7777777777777_
_111111111_____7777777777777_
_111111111_____7777777777777_
_111111111117777777777777777_
_111111111117777777777777777_
_111111111117777777777777777_
_111111111117777777777777777_
_111111111117777777777777777_
_111111111_____7777777777777_
_111111111_____7777777777777_
_111111111_____7777777777777_
_111111111_____7777777777777_
_111111111___________________
_111111111___________________
_111111111___________________
_111111111___________________
_111111111___________________
_111111111___________________
_111111111___________________
_111111111_____8888888888888_
_111111111_____8888888888888_
_111111111_____8888888888888_
_111111111_____8888888888888_
_111111111118888888888888888_
_111111111118888888888888888_
_111111111118888888888888888_
_111111111118888888888888888_
_111111111118888888888888888_
_111111111_____8888888888888_
_111111111_____8888888888888_
_111111111_____8888888888888_
_111111111_____8888888888888_
_111111111___________________
_111111111___________________
_111111111___________________
_111111111___________________
_111111111___________________
_111111111___________________
_111111111___________________
_111111111_____9999999999999_
_111111111_____9999999999999_
_111111111_____9999999999999_
_111111111_____9999999999999_
_111111111119999999999999999_
_111111111119999999999999999_
_111111111119999999999999999_
_111111111119999999999999999_
_111111111119999999999999999_
_111111111_____9999999999999_
_111111111_____9999999999999_
_111111111_____9999999999999_
_111111111_____9999999999999_
_111111111___________________
_111111111___________________
_111111111___________________
_111111111___________________
_111111111___________________
_111111111___________________
_111111111___________________
_111111111_____:::::::::::::_
_111111111_____:::::::::::::_
_111111111_____:::::::::::::_
_111111111_____:::::::::::::_
_11111111111::::::::::::::::_
_11111111111::::::::::::::::_
_11111111111::::::::::::::::_
_11111111111::::::::::::::::_
_11111111111::::::::::::::::_
_111111111_____:::::::::::::_
_111111111_____:::::::::::::_
_111111111_____:::::::::::::_
_111111111_____:::::::::::::_
_111111111___________________
_111111111___________________
_111111111___________________
_111111111___________________
_111111111___________________
_111111111___________________
