29
100
___________________000000000_
_1111111111111_____000000000_
_1111111111111_____000000000_
_1111111111111_____000000000_
_1111111111111_____000000000_
_11111111_1111_____000000000_
_11111111_1111_____000000000_
_11111111_000000000000000000_
_11111111_000000000000000000_
__________000000000000000000_
__________000000000000000000_
_66666666_000000000000000000_
_66666666_000000000000000000_
_66666666_6666_____000000000_
_66666666_6666_____000000000_
_6666666666666_____000000000_
_6666666666666_____000000000_
_6666666666666_____000000000_
_6666666666666_____000000000_
___________________000000000_
___________________000000000_
_2222222222222_____000000000_
_2222222222222_____000000000_
_2222222222222_____000000000_
_2222222222222_____000000000_
_22222222_2222_____000000000_
_22222222_2222_____000000000_
_22222222_000000000000000000_
_22222222_000000000000000000_
__________000000000000000000_
__________000000000000000000_
_77777777_000000000000000000_
_77777777_000000000000000000_
_77777777_7777_____000000000_
_77777777_7777_____000000000_
_7777777777777_____000000000_
_7777777777777_____000000000_
_7777777777777_____000000000_
_7777777777777_____000000000_
___________________000000000_
___________________000000000_
_3333333333333_____000000000_
_3333333333333_____000000000_
_3333333333333_____000000000_
_3333333333333_____000000000_
_33333333_3333_____000000000_
_33333333_3333_____000000000_
_33333333_000000000000000000_
_33333333_000000000000000000_
__________000000000000000000_
__________000000000000000000_
_88888888_000000000000000000_
_88888888_000000000000000000_
_88888888_8888_____000000000_
_88888888_8888_____000000000_
_8888888888888_____000000000_
_8888888888888_____000000000_
_8888888888888_____000000000_
_8888888888888_____000000000_
___________________000000000_
___________________000000000_
_4444444444444_____000000000_
_4444444444444_____000000000_
_4444444444444_____000000000_
_4444444444444_____000000000_
_44444444_4444_____000000000_
_44444444_4444_____000000000_
_44444444_000000000000000000_
_44444444_000000000000000000_
__________000000000000000000_
__________000000000000000000_
_99999999_000000000000000000_
_99999999_000000000000000000_
_99999999_9999_____000000000_
_99999999_9999_____000000000_
_9999999999999_____000000000_
_9999999999999_____000000000_
_9999999999999_____000000000_
_9999999999999_____000000000_
___________________000000000_
___________________000000000_
_5555555555555_____000000000_
_5555555555555_____000000000_
_5555555555555_____000000000_
_5555555555555_____000000000_
_55555555_5555_____000000000_
_55555555_5555_____000000000_
_55555555_000000000000000000_
_55555555_000000000000000000_
__________000000000000000000_
__________000000000000000000_
_::::::::_000000000000000000_
_::::::::_000000000000000000_
_::::::::_::::_____000000000_
_::::::::_::::_____000000000_
_:::::::::::::_____000000000_
_:::::::::::::_____000000000_
_:::::::::::::_____000000000_
_:::::::::::::_____000000000_
___________________000000000_
