_4
90
________________________000000000_
_111111_22222_33333_____000000000_
_111111_22222_33333_____000000000_
_111111_22222_33333_____000000000_
_111111_22222_33333_____000000000_
_____AA_AA_______AA_____000000000_
_444_AAAAAAAAAAAAAAAAAAA000000000_
_444_AAAAAAAAAAAAAAAAAAA000000000_
_444_AAAAAAAAAAAAAAAAAAA000000000_
_444_AAAAAAAAAAAAAA_____000000000_
_444_AAAAAAAAAAAAAA_____000000000_
_AAAAAAAAAAAAAAAAAA_____000000000_
_AAAAAAAAAAAAAAAAAA_____000000000_
_AAAAAAAAAAAAAAAAAA_____000000000_
________________________000000000_
________________________000000000_
________________________000000000_
________________________000000000_
________________________000000000_
_000000_00000_00000_____000000000_
_000000_00000_00000_____000000000_
_000000_00000_00000_____000000000_
_000000_00000_00000_____000000000_
_____77_77_______77_____000000000_
_BBB_7777777777777777777000000000_
_BBB_7777777777777777777000000000_
_BBB_7777777777777777777000000000_
_BBB_77777777777777_____000000000_
_BBB_77777777777777_____000000000_
_777777777777777777_____000000000_
_777777777777777777_____000000000_
_777777777777777777_____000000000_
________________________000000000_
________________________000000000_
________________________000000000_
________________________000000000_
________________________000000000_
_000000_00000_00000_____000000000_
_000000_00000_00000_____000000000_
_000000_00000_00000_____000000000_
_000000_00000_00000_____000000000_
_____88_88_______88_____000000000_
_CCC_8888888888888888888000000000_
_CCC_8888888888888888888000000000_
_CCC_8888888888888888888000000000_
_CCC_88888888888888_____000000000_
_CCC_88888888888888_____000000000_
_888888888888888888_____000000000_
_888888888888888888_____000000000_
_888888888888888888_____000000000_
________________________000000000_
________________________000000000_
________________________000000000_
________________________000000000_
________________________000000000_
_000000_00000_00000_____000000000_
_000000_00000_00000_____000000000_
_000000_00000_00000_____000000000_
_000000_00000_00000_____000000000_
_____99_99_______99_____000000000_
_DDD_9999999999999999999000000000_
_DDD_9999999999999999999000000000_
_DDD_9999999999999999999000000000_
_DDD_99999999999999_____000000000_
_DDD_99999999999999_____000000000_
_999999999999999999_____000000000_
_999999999999999999_____000000000_
_999999999999999999_____000000000_
________________________000000000_
________________________000000000_
________________________000000000_
________________________000000000_
________________________000000000_
_000000_00000_00000_____000000000_
_000000_00000_00000_____000000000_
_000000_00000_00000_____000000000_
_000000_00000_00000_____000000000_
_____AA_AA_______AA_____000000000_
_EEE_AAAAAAAAAAAAAAAAAAA000000000_
_EEE_AAAAAAAAAAAAAAAAAAA000000000_
_EEE_AAAAAAAAAAAAAAAAAAA000000000_
_EEE_AAAAAAAAAAAAAA_____000000000_
_EEE_AAAAAAAAAAAAAA_____000000000_
_AAAAAAAAAAAAAAAAAA_____000000000_
_AAAAAAAAAAAAAAAAAA_____000000000_
_AAAAAAAAAAAAAAAAAA_____000000000_
________________________000000000_
________________________000000000_
________________________000000000_
________________________000000000_
