54
140
_000000000____________________________________________
_000000000______________________________1111111111111_
_000000000______________________________1111111111111_
_000000000______________________________1111111111111_
_000000000______________________________1111111111111_
_0000000002222222222222222222222222222221111111111111_
_0000000002222222222222222222222222222221111111111111_
_0000000002222222222222222222222222222221111111111111_
_0000000002222222222222222222222222222221111111111111_
_0000000002222222222222222222222222222221111111111111_
_000000000_____33333____________________1111111111111_
_000000000_____33333____________________1111111111111_
_000000000_____33333____________________1111111111111_
_000000000_____33333____________________1111111111111_
_000000000_____33333__________________________________
_000000000_____33333_____5555555555555555555555555555_
_000000000_____33333_____5555555555555555555555555555_
_000000000_____33333_____5555555555555555555555555555_
_000000000_____33333_____5555555555555555555555555555_
_000000000_____44444444445555555555555555555555555555_
_000000000_____44444444445555555555555555555555555555_
_000000000_____44444444445555555555555555555555555555_
_000000000_____44444444445555555555555555555555555555_
_000000000_____44444444445555555555555555555555555555_
_000000000_______________5555555555555555555555555555_
_000000000_______________5555555555555555555555555555_
_000000000_______________5555555555555555555555555555_
_000000000_______________5555555555555555555555555555_
_000000000____________________________________________
_000000000______________________________6666666666666_
_000000000______________________________6666666666666_
_000000000______________________________6666666666666_
_000000000______________________________6666666666666_
_0000000007777777777777777777777777777776666666666666_
_0000000007777777777777777777777777777776666666666666_
_0000000007777777777777777777777777777776666666666666_
_0000000007777777777777777777777777777776666666666666_
_0000000007777777777777777777777777777776666666666666_
_000000000_____88888____________________6666666666666_
_000000000_____88888____________________6666666666666_
_000000000_____88888____________________6666666666666_
_000000000_____88888____________________6666666666666_
_000000000_____88888__________________________________
_000000000_____88888_____::::::::::::::::::::::::::::_
_000000000_____88888_____::::::::::::::::::::::::::::_
_000000000_____88888_____::::::::::::::::::::::::::::_
_000000000_____88888_____::::::::::::::::::::::::::::_
_000000000_____9999999999::::::::::::::::::::::::::::_
_000000000_____9999999999::::::::::::::::::::::::::::_
_000000000_____9999999999::::::::::::::::::::::::::::_
_000000000_____9999999999::::::::::::::::::::::::::::_
_000000000_____9999999999::::::::::::::::::::::::::::_
_000000000_______________::::::::::::::::::::::::::::_
_000000000_______________::::::::::::::::::::::::::::_
_000000000_______________::::::::::::::::::::::::::::_
_000000000_______________::::::::::::::::::::::::::::_
_000000000____________________________________________
_000000000______________________________;;;;;;;;;;;;;_
_000000000______________________________;;;;;;;;;;;;;_
_000000000______________________________;;;;;;;;;;;;;_
_000000000______________________________;;;;;;;;;;;;;_
_000000000<<<<<<<<<<<<<<<<<<<<<<<<<<<<<<;;;;;;;;;;;;;_
_000000000<<<<<<<<<<<<<<<<<<<<<<<<<<<<<<;;;;;;;;;;;;;_
_000000000<<<<<<<<<<<<<<<<<<<<<<<<<<<<<<;;;;;;;;;;;;;_
_000000000<<<<<<<<<<<<<<<<<<<<<<<<<<<<<<;;;;;;;;;;;;;_
_000000000<<<<<<<<<<<<<<<<<<<<<<<<<<<<<<;;;;;;;;;;;;;_
_000000000_____=====____________________;;;;;;;;;;;;;_
_000000000_____=====____________________;;;;;;;;;;;;;_
_000000000_____=====____________________;;;;;;;;;;;;;_
_000000000_____=====____________________;;;;;;;;;;;;;_
_000000000_____=====__________________________________
_000000000_____=====_____????????????????????????????_
_000000000_____=====_____????????????????????????????_
_000000000_____=====_____????????????????????????????_
_000000000_____=====_____????????????????????????????_
_000000000_____>>>>>>>>>>????????????????????????????_
_000000000_____>>>>>>>>>>????????????????????????????_
_000000000_____>>>>>>>>>>????????????????????????????_
_000000000_____>>>>>>>>>>????????????????????????????_
_000000000_____>>>>>>>>>>????????????????????????????_
_000000000_______________????????????????????????????_
_000000000_______________????????????????????????????_
_000000000_______________????????????????????????????_
_000000000_______________????????????????????????????_
_000000000____________________________________________
_000000000______________________________@@@@@@@@@@@@@_
_000000000______________________________@@@@@@@@@@@@@_
_000000000______________________________@@@@@@@@@@@@@_
_000000000______________________________@@@@@@@@@@@@@_
_000000000AAAAAAAAAAAAAAAAAAAAAAAAAAAAAA@@@@@@@@@@@@@_
_000000000AAAAAAAAAAAAAAAAAAAAAAAAAAAAAA@@@@@@@@@@@@@_
_000000000AAAAAAAAAAAAAAAAAAAAAAAAAAAAAA@@@@@@@@@@@@@_
_000000000AAAAAAAAAAAAAAAAAAAAAAAAAAAAAA@@@@@@@@@@@@@_
_000000000AAAAAAAAAAAAAAAAAAAAAAAAAAAAAA@@@@@@@@@@@@@_
_000000000_____BBBBB____________________@@@@@@@@@@@@@_
_000000000_____BBBBB____________________@@@@@@@@@@@@@_
_000000000_____BBBBB____________________@@@@@@@@@@@@@_
_000000000_____BBBBB____________________@@@@@@@@@@@@@_
_000000000_____BBBBB__________________________________
_000000000_____BBBBB_____DDDDDDDDDDDDDDDDDDDDDDDDDDDD_
_000000000_____BBBBB_____DDDDDDDDDDDDDDDDDDDDDDDDDDDD_
_000000000_____BBBBB_____DDDDDDDDDDDDDDDDDDDDDDDDDDDD_
_000000000_____BBBBB_____DDDDDDDDDDDDDDDDDDDDDDDDDDDD_
_000000000_____CCCCCCCCCCDDDDDDDDDDDDDDDDDDDDDDDDDDDD_
_000000000_____CCCCCCCCCCDDDDDDDDDDDDDDDDDDDDDDDDDDDD_
_000000000_____CCCCCCCCCCDDDDDDDDDDDDDDDDDDDDDDDDDDDD_
_000000000_____CCCCCCCCCCDDDDDDDDDDDDDDDDDDDDDDDDDDDD_
_000000000_____CCCCCCCCCCDDDDDDDDDDDDDDDDDDDDDDDDDDDD_
_000000000_______________DDDDDDDDDDDDDDDDDDDDDDDDDDDD_
_000000000_______________DDDDDDDDDDDDDDDDDDDDDDDDDDDD_
_000000000_______________DDDDDDDDDDDDDDDDDDDDDDDDDDDD_
_000000000_______________DDDDDDDDDDDDDDDDDDDDDDDDDDDD_
_000000000____________________________________________
_000000000______________________________EEEEEEEEEEEEE_
_000000000______________________________EEEEEEEEEEEEE_
_000000000______________________________EEEEEEEEEEEEE_
_000000000______________________________EEEEEEEEEEEEE_
_000000000FFFFFFFFFFFFFFFFFFFFFFFFFFFFFFEEEEEEEEEEEEE_
_000000000FFFFFFFFFFFFFFFFFFFFFFFFFFFFFFEEEEEEEEEEEEE_
_000000000FFFFFFFFFFFFFFFFFFFFFFFFFFFFFFEEEEEEEEEEEEE_
_000000000FFFFFFFFFFFFFFFFFFFFFFFFFFFFFFEEEEEEEEEEEEE_
_000000000FFFFFFFFFFFFFFFFFFFFFFFFFFFFFFEEEEEEEEEEEEE_
_000000000_____GGGGG____________________EEEEEEEEEEEEE_
_000000000_____GGGGG____________________EEEEEEEEEEEEE_
_000000000_____GGGGG____________________EEEEEEEEEEEEE_
_000000000_____GGGGG____________________EEEEEEEEEEEEE_
_000000000_____GGGGG__________________________________
_000000000_____GGGGG_____IIIIIIIIIIIIIIIIIIIIIIIIIIII_
_000000000_____GGGGG_____IIIIIIIIIIIIIIIIIIIIIIIIIIII_
_000000000_____GGGGG_____IIIIIIIIIIIIIIIIIIIIIIIIIIII_
_000000000_____GGGGG_____IIIIIIIIIIIIIIIIIIIIIIIIIIII_
_000000000_____HHHHHHHHHHIIIIIIIIIIIIIIIIIIIIIIIIIIII_
_000000000_____HHHHHHHHHHIIIIIIIIIIIIIIIIIIIIIIIIIIII_
_000000000_____HHHHHHHHHHIIIIIIIIIIIIIIIIIIIIIIIIIIII_
_000000000_____HHHHHHHHHHIIIIIIIIIIIIIIIIIIIIIIIIIIII_
_000000000_____HHHHHHHHHHIIIIIIIIIIIIIIIIIIIIIIIIIIII_
_000000000_______________IIIIIIIIIIIIIIIIIIIIIIIIIIII_
_000000000_______________IIIIIIIIIIIIIIIIIIIIIIIIIIII_
_000000000_______________IIIIIIIIIIIIIIIIIIIIIIIIIIII_
_000000000_______________IIIIIIIIIIIIIIIIIIIIIIIIIIII_
