8
14
33666666
30666666
30666666
30333666
30000666
30003666
30003666
30003666
30000666
30003666
30003666
30003666
30000003
33333333