8
14
33666666
30666666
30666666
30333666
30000666
30003333
30003003
30003003
30000003
30003333
30003003
30003003
30000003
33333333